"","Rank of Sales","Game","Owners Before","Owners After","Sales","Price","Increase(Percentage)","Max Discount(Percentage of Original)","Lowest Price"
"1",1,"PLAYERUNKNOWN'S BATTLEGROUNDS",45374000,64106000,18732000,29.99,41.28,33,19.99
"2",2,"Left 4 Dead 2",18189000,19143000,954000,9.99,5.24,90,1.99
"3",3,"PAYDAY 2",14866000,15410000,544000,9.99,3.66,50,4.99
"4",4,"Half-Life 2: Deathmatch",14435000,14725000,290000,4.99,2.01,90,0.79
"5",5,"Garry's Mod",13715000,14518000,803000,9.99,5.85,75,2.49
"6",6,"Counter-Strike: Condition Zero",7700000,11379000,3679000,9.99,47.78,90,0.99
"7",7,"Portal 2",8046000,10830000,2784000,9.99,34.6,90,1.99
"8",8,"Portal",10443000,10633000,190000,9.99,1.82,90,0.99
"9",9,"Grand Theft Auto V",9008000,9954000,946000,29.99,10.5,67,14.99
"10",10,"Half-Life 2",5189000,9878000,4689000,9.99,90.36,90,0.99
"11",11,"Terraria",9137000,9568000,431000,9.99,4.72,50,4.99
"12",12,"Deathmatch Classic",5276000,8462000,3186000,4.99,60.39,80,0.99
"13",13,"Half-Life Deathmatch: Source",8061000,8434000,373000,9.99,4.63,90,0.99
"14",14,"Borderlands 2",7826000,8078000,252000,19.99,3.22,75,4.99
"15",15,"Don't Starve Together",7244000,7746000,502000,14.99,6.93,60,5.99
"16",16,"Day of Defeat",7561000,7718000,157000,4.99,2.08,80,0.99
"17",17,"MONSTER HUNTER: WORLD",0,7407000,7407000,59.99,0,34,39.59
"18",18,"The Elder Scrolls V: Skyrim Special Edition",7180000,7196000,16000,39.99,0.22,50,19.99
"19",19,"Ricochet",5506000,7169000,1663000,4.99,30.2,90,0.49
"20",20,"Half-Life 2: Episode One",6839000,7052000,213000,7.99,3.11,90,0.79
"21",21,"Rust",6190000,6828000,638000,34.99,10.31,75,8.74
"22",22,"Day of Defeat: Source",4847000,6591000,1744000,9.99,35.98,90,0.99
"23",23,"Dead by Daylight",2949000,6359000,3410000,19.99,115.63,50,9.99
"24",24,"Half-Life 2: Episode Two",6058000,6165000,107000,7.99,1.77,90,0.79
"25",25,"Half-Life: Opposing Force",5784000,5983000,199000,4.99,3.44,80,0.99
"26",26,"Half-Life: Blue Shift",5893000,5904000,11000,4.99,0.19,80,0.99
"27",27,"ARK: Survival Evolved",5366000,5813000,447000,49.99,8.33,67,19.79
"28",28,"ARK: Survival Of The Fittest",5432000,5599000,167000,49.99,3.07,67,19.79
"29",29,"Chivalry: Medieval Warfare",5338000,5415000,77000,24.99,1.44,85,3.74
"30",30,"Euro Truck Simulator 2",4786000,5402000,616000,19.99,12.87,75,4.99
"31",31,"Left 4 Dead",5175000,5398000,223000,9.99,4.31,90,1.99
"32",32,"Tomb Raider",5185000,5381000,196000,19.99,3.78,85,2.99
"33",33,"Age of Empires II HD",4815000,5216000,401000,19.99,8.33,80,3.99
"34",34,"Wallpaper Engine",4423000,5140000,717000,3.99,16.21,0,3.99
"35",35,"The Witcher 3: Wild Hunt",4095000,5133000,1038000,39.99,25.35,50,19.99
"36",36,"Fallout 4",4696000,5049000,353000,29.99,7.52,50,14.99
"37",37,"Don't Starve",4623000,4825000,202000,9.99,4.37,75,2.49
"38",38,"Cities: Skylines",4259000,4727000,468000,29.99,10.99,75,7.49
"39",39,"Killing Floor",4662000,4704000,42000,19.99,0.9,85,2.99
"40",40,"Grand Theft Auto IV",4377000,4550000,173000,19.99,3.95,65,6.99
"41",41,"Outlast",4217000,4485000,268000,19.99,6.36,80,3.99
"42",42,"FOR HONOR",682000,4418000,3736000,14.99,547.8,75,7.49
"43",43,"Guns of Icarus Online",4229000,4405000,176000,4.99,4.16,90,0.49
"44",44,"BioShock Infinite",3791000,4395000,604000,29.99,15.93,75,7.49
"45",45,"LIMBO",3428000,4343000,915000,9.99,26.69,80,1.99
"46",46,"PAYDAY The Heist",4270000,4312000,42000,14.99,0.98,80,2.99
"47",47,"Saints Row: The Third",4202000,4266000,64000,9.99,1.52,75,2.49
"48",48,"Just Cause 2",4106000,4191000,85000,14.99,2.07,90,1.49
"49",49,"Middle-earth: Shadow of Mordor",3461000,4126000,665000,19.99,19.21,60,7.99
"50",50,"The Forest",3708000,4122000,414000,19.99,11.17,33,13.39
"51",51,"Castle Crashers",3466000,4072000,606000,14.99,17.48,80,2.99
"52",52,"DISTRAINT: Deluxe Edition",237000,4002000,3765000,4.99,1588.61,83,0.84
"53",53,"Arma 3",3564000,3918000,354000,39.99,9.93,66,13.59
"54",54,"Stardew Valley",3345000,3850000,505000,14.99,15.1,20,11.99
"55",55,"Torchlight II",3047000,3810000,763000,19.99,25.04,80,3.99
"56",56,"Call of Duty: Black Ops",3606000,3721000,115000,39.99,3.19,51,19.59
"57",57,"Total War: EMPIRE – Definitive Edition",3449000,3695000,246000,24.99,7.13,75,4.99
"58",58,"Saints Row IV",3475000,3647000,172000,14.99,4.95,75,3.74
"59",59,"Warhammer 40,000: Space Marine",1086000,3575000,2489000,29.99,229.19,75,7.49
"60",60,"Magicka",3493000,3524000,31000,9.99,0.89,75,2.49
"61",61,"Batman: Arkham City - Game of the Year Edition",2707000,3500000,793000,19.99,29.29,75,4.99
"62",62,"Half-Life: Source",3364000,3479000,115000,9.99,3.42,90,0.99
"63",63,"Far Cry 3",3311000,3461000,150000,19.99,4.53,66,6.79
"64",64,"Borderlands",3402000,3437000,35000,19.99,1.03,75,4.99
"65",65,"Sniper Elite V2",3387000,3417000,30000,19.99,0.89,70,5.99
"66",66,"Hacknet",682000,3390000,2708000,9.99,397.07,80,1.99
"67",67,"Layers of Fear",3039000,3368000,329000,19.99,10.83,75,4.99
"68",68,"Red Orchestra 2: Heroes of Stalingrad with Rising Storm",3257000,3342000,85000,19.99,2.61,75,4.99
"69",69,"Dishonored",3216000,3323000,107000,9.99,3.33,75,2.49
"70",70,"Company of Heroes 2",2429000,3317000,888000,19.99,36.56,75,3.24
"71",71,"Call of Duty: Black Ops II",3138000,3218000,80000,59.99,2.55,51,29.39
"72",72,"Saints Row 2",2407000,3160000,753000,9.99,31.28,75,2.49
"73",73,"Hitman: Absolution",2708000,3078000,370000,19.99,13.66,75,4.99
"74",74,"Undertale",2897000,3061000,164000,9.99,5.66,50,4.99
"75",75,"The Tiny Bang Story",209000,3010000,2801000,4.99,1340.19,75,1.24
"76",76,"BattleBlock Theater",2822000,2978000,156000,14.99,5.53,80,2.99
"77",77,"Batman: Arkham Asylum Game of the Year Edition",2909000,2961000,52000,19.99,1.79,75,4.99
"78",78,"Orwell: Keeping an Eye On You",267000,2950000,2683000,9.99,1004.87,60,3.99
"79",79,"Mount & Blade: Warband",2742000,2909000,167000,19.99,6.09,75,4.99
"80",80,"Starbound",2862000,2889000,27000,14.99,0.94,33,10.04
"81",81,"Dying Light",2558000,2865000,307000,39.99,12,60,15.99
"82",82,"Total War: ROME II - Emperor Edition",2601000,2857000,256000,59.95,9.84,75,14.98
"83",83,"Goat Simulator",2747000,2837000,90000,9.99,3.28,75,2.49
"84",84,"FTL: Faster Than Light",2743000,2816000,73000,9.99,2.66,75,2.49
"85",85,"Subnautica",2199000,2807000,608000,24.99,27.65,25,18.74
"86",86,"Mirror's Edge",2709000,2749000,40000,19.99,1.48,75,4.99
"87",87,"Grand Theft Auto: Episodes from Liberty City",2678000,2733000,55000,19.99,2.05,65,6.99
"88",88,"Super Meat Boy",2652000,2693000,41000,14.99,1.55,90,1.49
"89",89,"DARK SOULS III",2188000,2635000,447000,59.99,20.43,75,14.99
"90",90,"Trine 2: Complete Story",2246000,2617000,371000,19.99,16.52,85,2.99
"91",91,"Bastion",2071000,2603000,532000,14.99,25.69,80,2.99
"92",92,"Homefront",2569000,2571000,2000,19.99,0.08,75,4.99
"93",93,"Mafia II",2464000,2568000,104000,29.99,4.22,75,7.49
"94",94,"Sanctum 2",1501000,2544000,1043000,14.99,69.49,80,2.99
"95",95,"DOOM",2331000,2537000,206000,19.99,8.84,50,9.99
"96",96,"The Bureau: XCOM Declassified",2081000,2517000,436000,19.99,20.95,80,3.99
"97",97,"Divinity: Original Sin 2 - Definitive Edition",1827000,2491000,664000,44.99,36.34,35,29.24
"98",98,"Age of Empires III: Complete Collection",2467000,2471000,4000,39.99,0.16,75,9.99
"99",99,"Company of Heroes: Opposing Fronts",2409000,2463000,54000,19.99,2.24,75,4.99
"100",100,"Sid Meier's Civilization III Complete",2437000,2459000,22000,4.99,0.9,75,1.24
"101",101,"Amnesia: A Machine for Pigs",1668000,2433000,765000,19.99,45.86,85,2.99
"102",102,"F1 2015",2235000,2428000,193000,39.99,8.64,75,9.99
"103",103,"Orcs Must Die! 2",2120000,2420000,3e+05,14.99,14.15,75,3.74
"104",104,"Sid Meier’s Civilization VI",2224000,2420000,196000,59.99,8.81,70,17.99
"105",105,"Space Engineers",2225000,2414000,189000,39.99,8.49,60,9.99
"106",106,"Rise of the Tomb Raider",2099000,2403000,304000,59.99,14.48,80,11.99
"107",107,"South Park: The Stick of Truth",2294000,2384000,90000,29.99,3.92,75,7.49
"108",108,"Crusader Kings II",2200000,2373000,173000,39.99,7.86,75,9.99
"109",109,"This War of Mine",2230000,2370000,140000,19.99,6.28,75,4.99
"110",110,"Prison Architect",2306000,2370000,64000,29.99,2.78,75,7.49
"111",111,"Fallout 3: Game of the Year Edition",1920000,2341000,421000,19.99,21.93,50,9.99
"112",112,"Total War: NAPOLEON – Definitive Edition",2262000,2331000,69000,24.99,3.05,75,4.99
"113",113,"The Stanley Parable",1874000,2323000,449000,14.99,23.96,75,3.74
"114",114,"Brutal Legend",1396000,2312000,916000,14.99,65.62,85,2.24
"115",115,"ORION: Prelude",2286000,2307000,21000,0.99,0.92,37,0.62
"116",116,"Hotline Miami",2196000,2278000,82000,9.99,3.73,75,2.49
"117",117,"Dead Space",2255000,2276000,21000,19.99,0.93,75,4.99
"118",118,"Besiege",1763000,2252000,489000,9.99,27.74,40,5.99
"119",119,"Batman: Arkham Origins",2176000,2220000,44000,19.99,2.02,75,4.99
"120",120,"Kingdom: Classic",1329000,2213000,884000,4.99,66.52,60,1.99
"121",121,"Tropico 4",1685000,2204000,519000,14.99,30.8,80,2.99
"122",122,"太吾绘卷 The Scroll Of Taiwu",0,2197000,2197000,19.99,0,15,16.99
"123",123,"Titan Quest Anniversary Edition",2112000,2185000,73000,19.99,3.46,80,3.99
"124",124,"Total War: MEDIEVAL II – Definitive Edition",1999000,2182000,183000,24.99,9.15,75,4.99
"125",125,"Metro 2033 Redux",2041000,2173000,132000,19.99,6.47,66,6.79
"126",126,"Crysis 2 - Maximum Edition",2129000,2150000,21000,29.99,0.99,75,7.49
"127",127,"Borderlands: The Pre-Sequel",1959000,2129000,170000,39.99,8.68,70,11.99
"128",128,"Battlefield: Bad Company 2",2033000,2112000,79000,19.99,3.89,85,2.99
"129",129,"Papers, Please",1961000,2101000,140000,9.99,7.14,50,4.99
"130",130,"Metro: Last Light Redux",1689000,2099000,410000,19.99,24.27,66,6.79
"131",131,"Just Cause 3",1542000,2077000,535000,29.99,34.7,85,4.49
"132",132,"Alan Wake",1706000,2047000,341000,14.99,19.99,80,3
"133",133,"Kerbal Space Program",1925000,2002000,77000,39.99,4,60,15.99
"134",134,"The Binding of Isaac: Rebirth",1882000,1991000,109000,14.99,5.79,50,7.49
"135",135,"Burnout Paradise: The Ultimate Box",1624000,1983000,359000,19.99,22.11,75,4.99
"136",136,"SPORE",1851000,1973000,122000,19.99,6.59,85,2.99
"137",137,"Darkest Dungeon",1619000,1957000,338000,24.99,20.88,70,7.49
"138",138,"POSTAL 2",1574000,1916000,342000,9.99,21.73,90,0.99
"139",139,"Mad Max",1572000,1913000,341000,19.99,21.69,75,4.99
"140",140,"Banished",1837000,1909000,72000,19.99,3.92,66,6.79
"141",141,"Max Payne 3",1828000,1891000,63000,19.99,3.45,65,6.99
"142",142,"Mass Effect 2",1404000,1869000,465000,19.99,33.12,75,4.99
"143",143,"Dungeon Defenders",1518000,1837000,319000,14.99,21.01,75,3.74
"144",144,"The Sims 3",1698000,1833000,135000,19.99,7.95,85,2.99
"145",145,"Warhammer 40,000: Dawn of War II Chaos Rising",1789000,1813000,24000,19.99,1.34,75,4.99
"146",146,"Total War: WARHAMMER",1680000,1798000,118000,59.99,7.02,75,14.99
"147",147,"Grand Theft Auto III",1264000,1798000,534000,9.99,42.25,65,3.49
"148",148,"Stellaris",1429000,1788000,359000,39.99,25.12,60,15.99
"149",149,"Call of Duty: World at War",1701000,1779000,78000,19.99,4.59,51,9.79
"150",150,"DARK SOULS II: Scholar of the First Sin",1588000,1776000,188000,39.99,11.84,75,9.99
"151",151,"F.E.A.R. 3",1705000,1770000,65000,19.99,3.81,75,4.99
"152",152,"STAR WARS Jedi Knight - Jedi Academy",1687000,1764000,77000,9.99,4.56,65,3.49
"153",153,"XCOM 2",1650000,1764000,114000,59.99,6.91,75,14.99
"154",154,"Human: Fall Flat",1487000,1751000,264000,14.99,17.75,50,7.49
"155",155,"Cortex Command",1618000,1749000,131000,19.99,8.1,85,2.99
"156",156,"The Darkness II",1716000,1734000,18000,29.99,1.05,80,5.99
"157",157,"Jet Set Radio",1663000,1729000,66000,7.99,3.97,85,1.19
"158",158,"L.A. Noire",1624000,1722000,98000,19.99,6.03,65,6.99
"159",159,"Wolfenstein: The New Order",1605000,1717000,112000,19.99,6.98,67,6.59
"160",160,"Red Faction: Armageddon",1695000,1715000,20000,19.99,1.18,75,4.99
"161",161,"Surgeon Simulator",1696000,1713000,17000,9.99,1,85,1.49
"162",162,"Stick Fight: The Game",1272000,1709000,437000,4.99,34.36,25,3.74
"163",163,"Cuphead",1506000,1697000,191000,19.99,12.68,20,15.99
"164",164,"Assassin’s Creed IV Black Flag",1534000,1672000,138000,19.99,9,60,7.99
"165",165,"Risk of Rain",1535000,1659000,124000,9.99,8.08,80,1.99
"166",166,"Batman: Arkham Knight",1369000,1648000,279000,19.99,20.38,75,4.99
"167",167,"Deus Ex: Human Revolution - Director's Cut",1627000,1648000,21000,19.99,1.29,85,2.99
"168",168,"Golf With Your Friends",1630000,1643000,13000,5.99,0.8,35,3.89
"169",169,"Plague Inc: Evolved",1628000,1633000,5000,14.99,0.31,60,5.99
"170",170,"The Red Solstice",1505000,1632000,127000,9.99,8.44,85,1.49
"171",171,"The Elder Scrolls Online",1475000,1629000,154000,19.99,10.44,50,9.99
"172",172,"Mass Effect",1612000,1629000,17000,19.99,1.05,75,4.99
"173",173,"Broforce",1430000,1609000,179000,14.99,12.52,75,3.74
"174",174,"Warhammer 40,000: Dawn of War - Game of the Year Edition",1136000,1591000,455000,12.99,40.05,75,3.24
"175",175,"SpeedRunners",1495000,1587000,92000,14.99,6.15,67,4.94
"176",176,"Tabletop Simulator",1279000,1586000,307000,19.99,24,50,9.99
"177",177,"Natural Selection 2",1584000,1586000,2000,9.99,0.13,75,2.49
"178",178,"Shadowrun Returns",1057000,1579000,522000,14.99,49.39,75,3.74
"179",179,"Brothers - A Tale of Two Sons",1397000,1563000,166000,14.99,11.88,80,2.99
"180",180,"The Long Dark",1376000,1560000,184000,29.99,13.37,75,7.49
"181",181,"Sid Meier's Civilization IV",1553000,1558000,5000,19.99,0.32,75,4.99
"182",182,"Medal of Honor",1539000,1549000,10000,19.99,0.65,75,4.99
"183",183,"Orcs Must Die!",1256000,1545000,289000,9.99,23.01,75,2.49
"184",184,"Thief",1456000,1535000,79000,29.99,5.43,85,4.49
"185",185,"Scribblenauts Unlimited",1475000,1522000,47000,19.99,3.19,75,4.99
"186",186,"No Man's Sky",952000,1500000,548000,59.99,57.56,50,29.99
"187",187,"Europa Universalis IV",1387000,1497000,110000,39.99,7.93,75,9.99
"188",188,"Assassin's Creed Origins",1308000,1489000,181000,59.99,13.84,60,23.99
"189",189,"Stories: The Path of Destinies",1209000,1488000,279000,14.99,23.08,50,7.49
"190",190,"Dino D-Day",1467000,1486000,19000,9.99,1.3,90,0.99
"191",191,"Assassin's Creed 2 Deluxe Edition",1368000,1480000,112000,19.99,8.19,66,6.79
"192",192,"ARMA: Cold War Assault",1214000,1476000,262000,4.99,21.58,80,0.99
"193",193,"Football Manager 2018",372000,1471000,1099000,49.99,295.43,66,17
"194",194,"Sid Meier's Civilization: Beyond Earth",1445000,1465000,20000,39.99,1.38,75,9.99
"195",195,"Dead Space 2",1032000,1453000,421000,19.99,40.79,75,4.99
"196",196,"SCUM",0,1451000,1451000,19.99,0,20,15.99
"197",197,"To the Moon",1416000,1449000,33000,9.99,2.33,66,3.39
"198",198,"Hell Yeah! Wrath of the Dead Rabbit",1304000,1447000,143000,14.99,10.97,75,3.74
"199",199,"Factorio",1083000,1447000,364000,30,33.61,0,30
"200",200,"FEZ",1405000,1446000,41000,9.99,2.92,75,2.49
"201",201,"Sniper Elite 3",1331000,1433000,102000,29.99,7.66,80,5.99
"202",202,"RimWorld",806000,1430000,624000,34.99,77.42,0,29.99
"203",203,"Game Dev Tycoon",1379000,1429000,50000,9.99,3.63,75,2.49
"204",204,"Lord of the Rings: War in the North",1415000,1429000,14000,19.99,0.99,0,19.99
"205",205,"Alan Wake's American Nightmare",750000,1421000,671000,8.99,89.47,80,1.8
"206",206,"How to Survive",1320000,1417000,97000,14.99,7.35,90,1.49
"207",207,"Total War: WARHAMMER II",1289000,1409000,120000,59.99,9.31,50,29.99
"208",208,"METAL GEAR SOLID V: THE PHANTOM PAIN",1339000,1407000,68000,19.99,5.08,50,9.99
"209",209,"Killer is Dead - Nightmare Edition",1353000,1398000,45000,19.99,3.33,75,4.99
"210",210,"Transistor",1161000,1397000,236000,19.99,20.33,80,3.99
"211",211,"Dead Bits",1043000,1394000,351000,0.99,33.65,51,0.49
"212",212,"Civilization IV: Warlords",1335000,1377000,42000,4.99,3.15,75,1.24
"213",213,"Darksiders II Deathinitive Edition",992000,1375000,383000,29.99,38.61,85,4.49
"214",214,"Torchlight",968000,1370000,402000,14.99,41.53,80,2.99
"215",215,"Rogue Legacy",1295000,1357000,62000,14.99,4.79,80,2.99
"216",216,"Sleeping Dogs: Definitive Edition",1161000,1346000,185000,29.99,15.93,85,4.49
"217",217,"AudioSurf",995000,1345000,350000,9.99,35.18,75,2.49
"218",218,"Elite Dangerous",1175000,1344000,169000,29.99,14.38,76,7.19
"219",219,"Tropico 3",959000,1341000,382000,9.99,39.83,80,1.99
"220",220,"Civilization IV: Beyond the Sword",1112000,1340000,228000,9.99,20.5,75,2.49
"221",221,"Mortal Kombat X",1175000,1330000,155000,19.99,13.19,66,6.79
"222",222,"Sins of a Solar Empire: Rebellion",949000,1328000,379000,39.99,39.94,75,9.99
"223",223,"Resident Evil 6 / Biohazard 6",1119000,1314000,195000,29.99,17.43,75,7.49
"224",224,"Hero Siege",1242000,1302000,60000,5.99,4.83,90,0.59
"225",225,"Endless Space - Collection",692000,1300000,608000,19.99,87.86,90,1.99
"226",226,"Hotline Miami 2: Wrong Number",1100000,1288000,188000,14.99,17.09,75,3.74
"227",227,"Grim Dawn",1120000,1263000,143000,24.99,12.77,75,6.24
"228",228,"STAR WARS - Dark Forces",1206000,1257000,51000,5.99,4.23,66,2.03
"229",229,"Black Desert Online",1090000,1249000,159000,9.99,14.59,50,4.99
"230",230,"Middle-earth: Shadow of War",996000,1243000,247000,49.99,24.8,66,16.99
"231",231,"Alien: Isolation",1140000,1241000,101000,39.99,8.86,75,9.99
"232",232,"DmC: Devil May Cry",1183000,1231000,48000,29.99,4.06,75,7.49
"233",233,"Viking: Battle for Asgard",931000,1224000,293000,14.99,31.47,90,1.49
"234",234,"Risen 2: Dark Waters",1184000,1214000,30000,9.99,2.53,66,3.39
"235",235,"中国式家长 / Chinese Parents",1000,1213000,1212000,9.99,121200,22,7.79
"236",236,"SimCity 4 Deluxe Edition",1098000,1211000,113000,19.99,10.29,75,4.99
"237",237,"Warhammer: End Times - Vermintide",981000,1209000,228000,29.99,23.24,75,7.49
"238",238,"Dead Cells",9e+05,1208000,308000,24.99,34.22,40,11.99
"239",239,"Hitman 2: Silent Assassin",1056000,1208000,152000,8.99,14.39,75,2.24
"240",240,"Age of Mythology: Extended Edition",1144000,1204000,60000,29.99,5.24,75,7.49
"241",241,"Planet Coaster",1100000,1203000,103000,44.99,9.36,60,17.99
"242",242,"Far Cry 2: Fortune's Edition",1186000,1200000,14000,9.99,1.18,60,3.99
"243",243,"Mortal Kombat Komplete Edition",1164000,1199000,35000,19.99,3.01,75,4.99
"244",244,"Kingdom Come: Deliverance",1093000,1198000,105000,59.99,9.61,40,35.99
"245",245,"Hearts of Iron IV",928000,1193000,265000,39.99,28.56,60,15.99
"246",246,"Far Cry 3 - Blood Dragon",1170000,1186000,16000,14.99,1.37,60,5.99
"247",247,"Tropico 5",1113000,1181000,68000,19.99,6.11,80,3.99
"248",248,"Slay the Spire",731000,1181000,450000,15.99,61.56,37,10.07
"249",249,"Hollow Knight",810000,1179000,369000,14.99,45.56,34,9.89
"250",250,"Knights and Merchants",1107000,1178000,71000,6.99,6.41,85,1.04
"251",251,"Total War: ATTILA",1013000,1177000,164000,44.99,16.19,80,8.99
"252",252,"STAR WARS - The Force Unleashed Ultimate Sith Edition",1151000,1175000,24000,19.99,2.09,65,6.99
"253",253,"Enter the Gungeon",893000,1174000,281000,14.99,31.47,50,7.49
"254",254,"Aliens vs. Predator",1144000,1174000,30000,14.99,2.62,90,1.49
"255",255,"Dragon Age: Origins - Ultimate Edition",1156000,1171000,15000,29.99,1.3,75,7.49
"256",256,"Sanctum",1144000,1166000,22000,9.99,1.92,80,1.99
"257",257,"Resident Evil 5/ Biohazard 5",1089000,1162000,73000,19.99,6.7,75,4.99
"258",258,"Need For Speed: Hot Pursuit",1108000,1158000,50000,19.99,4.51,85,2.99
"259",259,"ShellShock Live",913000,1155000,242000,6.99,26.51,40,4.19
"260",260,"Earth 2160",913000,1155000,242000,4.99,26.51,80,0.99
"261",261,"Supreme Commander 2",1116000,1154000,38000,12.99,3.41,75,3.24
"262",262,"Geometry Dash",1028000,1152000,124000,3.99,12.06,75,0.99
"263",263,"Dust: An Elysian Tail",1119000,1150000,31000,14.99,2.77,75,3.74
"264",264,"Warhammer 40,000: Dawn of War - Soulstorm",1113000,1147000,34000,12.99,3.05,75,3.24
"265",265,"S.T.A.L.K.E.R.: Shadow of Chernobyl",822000,1143000,321000,19.99,39.05,70,5.99
"266",266,"SPINTIRES",1104000,1142000,38000,14.99,3.44,45,8.24
"267",267,"S.T.A.L.K.E.R.: Call of Pripyat",1044000,1141000,97000,19.99,9.29,70,5.99
"268",268,"Sniper: Ghost Warrior 2",859000,1138000,279000,9.99,32.48,85,1.79
"269",269,"FINAL FANTASY VII",1123000,1137000,14000,11.99,1.25,50,5.99
"270",270,"Deus Ex: Mankind Divided",914000,1135000,221000,29.99,24.18,85,4.49
"271",271,"DiRT Rally",991000,1135000,144000,39.99,14.53,80,7.99
"272",272,"Depth",936000,1133000,197000,19.99,21.05,75,4.99
"273",273,"Pillars of Eternity",1106000,1132000,26000,29.99,2.35,40,17.99
"274",274,"GRID 2",1090000,1131000,41000,29.99,3.76,75,7.49
"275",275,"Call of Duty 4: Modern Warfare",1088000,1130000,42000,19.99,3.86,51,9.79
"276",276,"Two Worlds Epic Edition",1064000,1119000,55000,9.99,5.17,85,1.49
"277",277,"The Escapists",926000,1118000,192000,17.99,20.73,75,4.49
"278",278,"World of Goo",1098000,1117000,19000,9.99,1.73,80,1.99
"279",279,"American Truck Simulator",961000,1112000,151000,19.99,15.71,75,4.99
"280",280,"Getting Over It with Bennett Foddy",1029000,1110000,81000,7.99,7.87,40,4.79
"281",281,"Assassin’s Creed III",1069000,1102000,33000,19.99,3.09,66,6.79
"282",282,"DARK SOULS II",1083000,1101000,18000,39.99,1.66,75,9.99
"283",283,"Mount & Blade",1069000,1101000,32000,9.99,2.99,75,2.49
"284",284,"Dishonored 2",913000,1099000,186000,39.99,20.37,67,13.19
"285",285,"Hitman: Codename 47",972000,1094000,122000,7.99,12.55,75,1.99
"286",286,"Frostpunk",720000,1094000,374000,29.99,51.94,33,19.99
"287",287,"Antichamber",896000,1086000,190000,19.99,21.21,75,4.99
"288",288,"Turbo Pug DX",791000,1086000,295000,0.99,37.29,51,0.49
"289",289,"STAR WARS: The Force Unleashed II",928000,1085000,157000,19.99,16.92,65,6.99
"290",290,"The Wolf Among Us",1043000,1083000,40000,14.99,3.84,60,9.99
"291",291,"Worms Revolution",1037000,1080000,43000,14.99,4.15,80,2.99
"292",292,"VVVVVV",1048000,1078000,30000,4.99,2.86,50,2.49
"293",293,"Eador. Masters of the Broken World",845000,1069000,224000,19.99,26.51,80,3.99
"294",294,"Sniper: Ghost Warrior",1011000,1056000,45000,7.99,4.45,85,1.19
"295",295,"Fallout 2: A Post Nuclear Role Playing Game",897000,1048000,151000,9.99,16.83,75,2.49
"296",296,"Assassin's Creed Odyssey",0,1046000,1046000,59.99,0,33,40.19
"297",297,"Dungeons 2",1003000,1044000,41000,19.99,4.09,85,2.99
"298",298,"Gang Beasts",994000,1044000,50000,19.99,5.03,37,12.59
"299",299,"Contagion",765000,1043000,278000,9.99,36.34,75,2.49
"300",300,"Crysis",1013000,1037000,24000,19.99,2.37,75,4.99
"301",301,"Planetary Annihilation",998000,1033000,35000,29.99,3.51,0,29.99
"302",302,"X-COM: UFO Defense",1027000,1032000,5000,4.99,0.49,75,1.24
"303",303,"Skullgirls",976000,1029000,53000,9.99,5.43,70,2.99
"304",304,"Injustice: Gods Among Us Ultimate Edition",992000,1029000,37000,19.99,3.73,75,4.99
"305",305,"Dark Messiah of Might & Magic",998000,1025000,27000,9.99,2.71,75,2.49
"306",306,"Defy Gravity Extended",974000,1009000,35000,1.99,3.59,75,0.49
"307",307,"NARUTO SHIPPUDEN: Ultimate Ninja STORM 4",786000,1003000,217000,29.99,27.61,75,7.49
"308",308,"Super Hexagon",866000,1003000,137000,2.99,15.82,69,0.92
"309",309,"Overlord II",984000,1001000,17000,9.99,1.73,75,2.49
"310",310,"Who's Your Daddy",860000,1001000,141000,4.99,16.4,25,3.74
"311",311,"Slime Rancher",932000,998000,66000,19.99,7.08,50,9.99
"312",312,"Ryse: Son of Rome",951000,997000,46000,14.99,4.84,75,3.74
"313",313,"ASTRONEER",928000,992000,64000,29.99,6.9,20,15.99
"314",314,"Supreme Commander: Forged Alliance",713000,992000,279000,12.99,39.13,80,2.59
"315",315,"Verdun",870000,982000,112000,24.99,12.87,60,9.99
"316",316,"Microsoft Flight Simulator X: Steam Edition",920000,975000,55000,24.99,5.98,70,7.49
"317",317,"Ori and the Blind Forest: Definitive Edition",855000,974000,119000,19.99,13.92,50,9.99
"318",318,"Bully: Scholarship Edition",907000,974000,67000,14.99,7.39,65,5.24
"319",319,"SpaceChem",945000,972000,27000,9.99,2.86,75,2.49
"320",320,"Lara Croft and the Guardian of Light",959000,970000,11000,9.99,1.15,85,1.49
"321",321,"Train Simulator 2019",890000,968000,78000,29.99,8.76,77,9.19
"322",322,"LEGO Marvel Super Heroes",916000,968000,52000,19.99,5.68,75,4.99
"323",323,"Gorky 17",779000,967000,188000,4.99,24.13,80,0.99
"324",324,"Deadlight",844000,965000,121000,14.99,14.34,80,2.99
"325",325,"Project CARS",903000,959000,56000,29.99,6.2,75,7.49
"326",326,"Project Zomboid",836000,955000,119000,14.99,14.23,40,8.99
"327",327,"Deponia",833000,954000,121000,39.99,14.53,90,0.99
"328",328,"SUPERHOT",813000,950000,137000,24.99,16.85,50,12.49
"329",329,"Spelunky",866000,944000,78000,14.99,9.01,80,2.99
"330",330,"Two Worlds II HD",786000,944000,158000,19.99,20.1,75,4.99
"331",331,"Dragon's Dogma: Dark Arisen",826000,942000,116000,29.99,14.04,70,8.99
"332",332,"Magicka 2",763000,941000,178000,14.99,23.33,75,3.74
"333",333,"Crysis Warhead",912000,939000,27000,19.99,2.96,75,4.99
"334",334,"Assassin’s Creed Brotherhood",884000,939000,55000,19.99,6.22,60,7.99
"335",335,"Deus Ex: Invisible War",910000,938000,28000,6.99,3.08,86,0.97
"336",336,"The Talos Principle",856000,933000,77000,39.99,9,85,5.99
"337",337,"STAR WARS Jedi Knight - Mysteries of the Sith",811000,927000,116000,2.99,14.3,66,1.01
"338",338,"Five Nights at Freddy's",903000,926000,23000,4.99,2.55,75,1.24
"339",339,"FINAL FANTASY XIV Online",785000,925000,140000,19.99,17.83,0,19.99
"340",340,"Resident Evil Revelations 2 / Biohazard Revelations 2",869000,925000,56000,5.99,6.44,87,0.77
"341",341,"Sonic & All-Stars Racing Transformed Collection",882000,924000,42000,19.99,4.76,75,4.99
"342",342,"Mafia III",767000,922000,155000,39.99,20.21,75,9.99
"343",343,"Command & Conquer: Red Alert 3",863000,919000,56000,19.99,6.49,75,4.99
"344",344,"Tomb Raider: Underworld",9e+05,916000,16000,8.99,1.78,89,0.98
"345",345,"Black Mesa",680000,914000,234000,19.99,34.41,60,7.99
"346",346,"NBA 2K18",603000,911000,308000,59.99,51.08,84,9.59
"347",347,"METAL GEAR SOLID V: GROUND ZEROES",863000,910000,47000,19.99,5.45,80,3.99
"348",348,"Valkyria Chronicles",875000,908000,33000,19.99,3.77,66,6.79
"349",349,"Kingdoms of Amalur: Reckoning",878000,907000,29000,19.99,3.3,75,4.99
"350",350,"Conan Exiles",847000,899000,52000,39.99,6.14,50,19.99
"351",351,"resident evil 4 / biohazard 4",817000,898000,81000,19.99,9.91,75,4.99
"352",352,"Tales from the Borderlands",803000,896000,93000,14.99,11.58,60,9.99
"353",353,"Supreme Commander",742000,894000,152000,12.99,20.49,80,2.59
"354",354,"Firewatch",772000,890000,118000,19.99,15.28,75,4.99
"355",355,"NieR:Automata",712000,889000,177000,59.99,24.86,50,29.99
"356",356,"Dragon Age: Origins",794000,888000,94000,19.99,11.84,85,2.99
"357",357,"Artifact",0,887000,887000,19.99,0,0,19.99
"358",358,"Tomb Raider: Legend",778000,886000,108000,6.99,13.88,86,0.97
"359",359,"Tom Clancy’s Splinter Cell Blacklist",861000,885000,24000,29.99,2.79,66,10.19
"360",360,"Renegade Ops",854000,880000,26000,15,3.04,80,3
"361",361,"Assassin's Creed: Director's Cut Edition",832000,879000,47000,19.99,5.65,66,6.79
"362",362,"Lost Castle",673000,874000,201000,9.99,29.87,45,5.49
"363",363,"S.T.A.L.K.E.R.: Clear Sky",773000,870000,97000,9.99,12.55,70,2.99
"364",364,"Binary Domain",736000,866000,130000,14.99,17.66,75,3.74
"365",365,"Scrap Mechanic",726000,866000,140000,19.99,19.28,40,11.99
"366",366,"Quantum Break",613000,864000,251000,39.99,40.95,75,9.99
"367",367,"Fallout 3",827000,862000,35000,9.99,4.23,75,2.49
"368",368,"Far Cry 5",745000,862000,117000,59.99,15.7,50,29.99
"369",369,"STAR WARS Starfighter",527000,860000,333000,5.99,63.19,66,2.03
"370",370,"DEFCON",842000,859000,17000,9.99,2.02,85,1.49
"371",371,"INSIDE",695000,853000,158000,19.99,22.73,60,7.99
"372",372,"Worms Reloaded",845000,852000,7000,19.99,0.83,80,3.99
"373",373,"Town of Salem",737000,850000,113000,4.99,15.33,50,2.49
"374",374,"Red Orchestra: Ostfront 41-45",808000,848000,40000,9.99,4.95,85,1.49
"375",375,"Anno 2070",833000,848000,15000,19.99,1.8,75,4.99
"376",376,"Stranded Deep",835000,841000,6000,14.99,0.72,0,14.99
"377",377,"Call of Duty: WWII",830000,841000,11000,59.99,1.33,40,35.99
"378",378,"Evolvation",2000,840000,838000,9.99,41900,25,7.49
"379",379,"Anomaly: Warzone Earth",819000,839000,20000,9.99,2.44,85,1.49
"380",380,"Assassin's Creed Revelations",788000,836000,48000,19.99,6.09,60,7.99
"381",381,"Ultimate Chicken Horse",648000,835000,187000,14.99,28.86,50,7.49
"382",382,"Sid Meier's Pirates!",778000,834000,56000,9.99,7.2,75,2.49
"383",383,"FINAL FANTASY XV WINDOWS EDITION",446000,833000,387000,49.99,86.77,50,24.99
"384",384,"Viscera Cleanup Detail: Santa's Rampage",804000,832000,28000,2.49,3.48,33,1.66
"385",385,"The Evil Within",733000,831000,98000,19.99,13.37,75,4.99
"386",386,"Sonic Generations Collection",741000,829000,88000,19.99,11.88,75,4.99
"387",387,"Gunpoint",710000,829000,119000,9.99,16.76,50,4.99
"388",388,"The Descendant",647000,825000,178000,14.99,27.51,67,4.94
"389",389,"The Incredible Adventures of Van Helsing",588000,823000,235000,14.99,39.97,75,3.74
"390",390,"Stronghold Crusader 2",663000,819000,156000,39.99,23.53,90,3.99
"391",391,"Gauntlet Slayer Edition",769000,816000,47000,19.99,6.11,75,4.99
"392",392,"Little Inferno",729000,814000,85000,9.99,11.66,50,4.99
"393",393,"Move or Die",703000,812000,109000,14.99,15.5,67,4.94
"394",394,"Oxygen Not Included",563000,811000,248000,24.99,44.05,25,18.74
"395",395,"Superbrothers: Sword & Sworcery EP",661000,811000,150000,7.99,22.69,70,2.39
"396",396,"Watch_Dogs 2",723000,810000,87000,59.99,12.03,70,17.99
"397",397,"The Swapper",797000,807000,10000,14.99,1.25,85,2.24
"398",398,"Guacamelee! Gold Edition",764000,807000,43000,14.99,5.63,85,2.25
"399",399,"Rise of Nations: Extended Edition",772000,799000,27000,19.99,3.5,75,4.99
"400",400,"Duck Game",687000,797000,110000,12.99,16.01,61,5.06
"401",401,"SPORE Creepy & Cute Parts Pack",788000,794000,6000,19.99,0.76,75,4.99
"402",402,"Starpoint Gemini 2",703000,793000,90000,34.99,12.8,85,5.24
"403",403,"Worms Armageddon",744000,791000,47000,14.99,6.32,80,2.99
"404",404,"Wargame: European Escalation",782000,790000,8000,9.99,1.02,85,1.49
"405",405,"Overcast - Walden and the Werewolf",737000,788000,51000,0.99,6.92,51,0.49
"406",406,"DRAGON BALL XENOVERSE",681000,788000,107000,39.99,15.71,75,9.99
"407",407,"HuniePop",643000,787000,144000,9.99,22.4,75,2.49
"408",408,"Shadowrun: Dragonfall - Director's Cut",758000,787000,29000,14.99,3.83,75,3.74
"409",409,"Miscreated",760000,782000,22000,24.99,2.89,60,9.99
"410",410,"Wolfenstein: The Old Blood",641000,776000,135000,19.99,21.06,67,6.59
"411",411,"BeamNG.drive",557000,771000,214000,24.99,38.42,33,16.74
"412",412,"Cities in Motion 2",739000,771000,32000,19.99,4.33,75,4.99
"413",413,"Tomb Raider I",764000,770000,6000,6.99,0.79,86,0.97
"414",414,"Overcooked",578000,767000,189000,16.99,32.7,75,4.24
"415",415,"HELLDIVERS A New Hell Edition",655000,767000,112000,19.99,17.1,50,9.99
"416",416,"Zombie Army Trilogy",654000,767000,113000,44.99,17.28,80,8.99
"417",417,"Divinity II: Developer's Cut",576000,762000,186000,19.99,32.29,90,1.99
"418",418,"Race The Sun",630000,760000,130000,9.99,20.63,80,1.99
"419",419,"Warhammer 40,000: Dawn of War III",649000,759000,110000,39.99,16.95,80,7.99
"420",420,"Uplink",745000,759000,14000,9.99,1.88,85,1.49
"421",421,"Ultra Street Fighter IV",743000,755000,12000,29.99,1.62,75,7.49
"422",422,"Woodle Tree Adventures",702000,754000,52000,2.99,7.41,0,2.99
"423",423,"Murdered: Soul Suspect",727000,751000,24000,29.99,3.3,90,2.99
"424",424,"Wasteland 2: Director's Cut",710000,750000,40000,29.99,5.63,50,14.99
"425",425,"Car Mechanic Simulator 2015",741000,749000,8000,19.99,1.08,90,1.99
"426",426,"Cave Story+",718000,748000,30000,14.99,4.18,50,7.49
"427",427,"Remember Me",743000,745000,2000,29.99,0.27,80,5.99
"428",428,"Dead Rising 2",708000,745000,37000,19.99,5.23,70,5.99
"429",429,"Wargame: Red Dragon",478000,745000,267000,29.99,55.86,70,8.99
"430",430,"Hand Simulator",721000,744000,23000,1.99,3.19,50,0.99
"431",431,"Sniper Elite 4",613000,743000,130000,59.99,21.21,85,8.99
"432",432,"Warlock - Master of the Arcane",734000,743000,9000,24.99,1.23,75,6.24
"433",433,"Game of Thrones - A Telltale Games Series",718000,740000,22000,14.99,3.06,50,14.99
"434",434,"Operation Flashpoint: Dragon Rising",707000,740000,33000,9.99,4.67,75,2.49
"435",435,"Northgard",569000,738000,169000,29.99,29.7,50,14.99
"436",436,"Darwinia",709000,737000,28000,9.99,3.95,85,1.49
"437",437,"Hand of Fate",654000,729000,75000,19.99,11.47,50,9.99
"438",438,"Mirror",367000,728000,361000,1.99,98.37,60,0.79
"439",439,"RollerCoaster Tycoon: Deluxe",642000,726000,84000,5.99,13.08,66,2.03
"440",440,"Mount Your Friends",694000,724000,30000,4.99,4.32,60,1.99
"441",441,"Baldur's Gate: Enhanced Edition",664000,724000,60000,19.99,9.04,75,4.99
"442",442,"METAL GEAR RISING: REVENGEANCE",680000,723000,43000,29.99,6.32,75,7.49
"443",443,"Raft",410000,722000,312000,19.99,76.1,15,16.99
"444",444,"Back to Bed",714000,721000,7000,5.99,0.98,80,1.19
"445",445,"Day of Infamy",565000,721000,156000,14.99,27.61,75,4.49
"446",446,"ABZU",611000,721000,110000,19.99,18,50,9.99
"447",447,"Saints Row: Gat out of Hell",672000,720000,48000,14.99,7.14,75,3.74
"448",448,"Kane & Lynch 2: Dog Days",705000,720000,15000,9.99,2.13,90,0.99
"449",449,"Hurtworld",643000,719000,76000,24.99,11.82,50,12.49
"450",450,"Men of War: Assault Squad 2",645000,719000,74000,29.99,11.47,80,5.99
"451",451,"Galactic Civilizations II: Ultimate Edition",579000,717000,138000,19.99,23.83,80,3.99
"452",452,"Tomb Raider III",592000,713000,121000,6.99,20.44,86,0.97
"453",453,"Blood and Bacon",643000,710000,67000,0.99,10.42,51,0.49
"454",454,"The Banner Saga",704000,710000,6000,24.99,0.85,75,4.99
"455",455,"They Are Billions",562000,705000,143000,24.99,25.44,25,18.74
"456",456,"SOMA",581000,702000,121000,29.99,20.83,80,5.99
"457",457,"Assassin's Creed Unity",6e+05,702000,102000,29.99,17,66,10.19
"458",458,"theHunter: Call of the Wild",574000,7e+05,126000,19.99,21.95,50,13.39
"459",459,"Prey",577000,696000,119000,29.99,20.62,50,14.99
"460",460,"Portal Knights",654000,696000,42000,19.99,6.42,65,7
"461",461,"Child of Light",670000,695000,25000,14.99,3.73,66,5.09
"462",462,"Farming Simulator 15",674000,694000,20000,19.99,2.97,50,9.99
"463",463,"Fable - The Lost Chapters",626000,693000,67000,9.99,10.7,75,2.49
"464",464,"Teleglitch: Die More Edition",403000,689000,286000,12.99,70.97,75,3.24
"465",465,"Assetto Corsa",505000,688000,183000,19.99,36.24,50,9.99
"466",466,"FINAL FANTASY XIII",659000,684000,25000,15.99,3.79,50,7.99
"467",467,"Turbo Pug",523000,684000,161000,0.99,30.78,51,0.49
"468",468,"Frozen Synapse",567000,683000,116000,24.99,20.46,80,4.99
"469",469,"Stronghold 3 Gold",594000,682000,88000,29.99,14.81,90,2.99
"470",470,"Reus",665000,682000,17000,9.99,2.56,75,2.49
"471",471,"Bloody Trapland",270000,681000,411000,9.99,152.22,90,0.99
"472",472,"Homeworld Remastered Collection",648000,680000,32000,34.99,4.94,75,8.74
"473",473,"Galactic Civilizations III",625000,678000,53000,39.99,8.48,75,9.99
"474",474,"Nidhogg",642000,676000,34000,9.99,5.3,65,3.49
"475",475,"One Finger Death Punch",659000,673000,14000,4.99,2.12,80,0.99
"476",476,"Dead Rising 3 Apocalypse Edition",556000,671000,115000,29.99,20.68,70,8.99
"477",477,"Worms Ultimate Mayhem",634000,669000,35000,14.99,5.52,80,2.99
"478",478,"Multiwinia",659000,669000,10000,9.99,1.52,85,1.49
"479",479,"Prototype 2",551000,669000,118000,39.99,21.42,75,9.99
"480",480,"Resident Evil Revelations / Biohazard Revelations",626000,668000,42000,29.99,6.71,77,6.89
"481",481,"Age of Wonders III",637000,667000,30000,29.99,4.71,75,7.49
"482",482,"BEEP",630000,666000,36000,1.99,5.71,75,0.49
"483",483,"Bold New World",657000,665000,8000,0.99,1.22,51,0.49
"484",484,"Max Payne 2: The Fall of Max Payne",553000,662000,109000,9.99,19.71,65,3.49
"485",485,"Commandos 2: Men of Courage",609000,661000,52000,4.99,8.54,90,0.49
"486",486,"Thief: Deadly Shadows",657000,659000,2000,8.99,0.3,89,0.98
"487",487,"NEKOPARA Vol. 1",525000,658000,133000,9.99,25.33,60,3.99
"488",488,"Might & Magic: Heroes VI",641000,657000,16000,19.99,2.5,75,4.99
"489",489,"Divine Divinity",641000,654000,13000,5.99,2.03,90,0.59
"490",490,"Gone Home",524000,653000,129000,14.99,24.62,80,3
"491",491,"Satellite Reign",599000,652000,53000,29.99,8.85,85,4.49
"492",492,"NARUTO SHIPPUDEN: Ultimate Ninja STORM 3 Full Burst HD",633000,652000,19000,19.99,3,50,9.99
"493",493,"X-Blades",619000,649000,30000,9.99,4.85,90,0.99
"494",494,"FINAL FANTASY VIII",637000,649000,12000,11.99,1.88,50,5.99
"495",495,"The Deer",563000,647000,84000,0.99,14.92,0,0.99
"496",496,"Crayon Physics Deluxe",572000,645000,73000,19.99,12.76,90,1.99
"497",497,"Shadowrun: Hong Kong - Extended Edition",591000,644000,53000,19.99,8.97,75,4.99
"498",498,"Puzzle Agent",631000,642000,11000,4.99,1.74,75,1.24
"499",499,"X-COM: Enforcer",97000,642000,545000,4.99,561.86,75,1.24
"500",500,"Heroes of Might & Magic III - HD Edition",581000,640000,59000,14.99,10.15,66,5.09
"501",501,"Beholder",468000,640000,172000,9.99,36.75,85,1.49
"502",502,"ICEY",523000,639000,116000,10.99,22.18,40,6.59
"503",503,"Farming Simulator 17",555000,638000,83000,24.99,14.95,70,7.49
"504",504,"How to Survive 2",633000,638000,5000,14.99,0.79,75,3.74
"505",505,"Particula",633000,637000,4000,0.99,0.63,84,0.49
"506",506,"The Witness",576000,637000,61000,39.99,10.59,70,11.99
"507",507,"Doom 3: BFG Edition",597000,635000,38000,19.99,6.37,60,7.99
"508",508,"Punch Club",594000,633000,39000,9.99,6.57,50,4.99
"509",509,"Planetary Annihilation: TITANS",550000,632000,82000,39.99,14.91,80,7.99
"510",510,"RESIDENT EVIL 7 biohazard / BIOHAZARD 7 resident evil",518000,629000,111000,29.99,21.43,35,19.49
"511",511,"NEKOPARA Vol. 0",589000,628000,39000,2.99,6.62,60,1.19
"512",512,"Door Kickers",516000,625000,109000,19.99,21.12,85,2.99
"513",513,"House Flipper",2e+05,625000,425000,19.99,212.5,23,15.39
"514",514,"Jurassic World Evolution",405000,624000,219000,54.99,54.07,60,21.99
"515",515,"Rocksmith 2014 Edition - Remastered",578000,622000,44000,39.99,7.61,70,11.99
"516",516,"Friday the 13th: The Game",460000,622000,162000,19.99,35.22,85,5.99
"517",517,"Cthulhu Saves the World",617000,621000,4000,2.99,0.65,83,0.5
"518",518,"Planets Under Attack",551000,621000,70000,9.99,12.7,90,0.99
"519",519,"GRID Autosport",575000,620000,45000,39.99,7.83,75,9.99
"520",520,"Pixel Piracy",543000,618000,75000,9.99,13.81,50,4.99
"521",521,"METAL SLUG 3",446000,618000,172000,7.99,38.57,50,3.99
"522",522,"Assassin's Creed Syndicate",503000,616000,113000,39.99,22.47,66,13.59
"523",523,"LEGO The Lord of the Rings",603000,614000,11000,19.99,1.82,75,4.99
"524",524,"Sonic Adventure DX",565000,611000,46000,7.99,8.14,85,1.19
"525",525,"Shadow Tactics: Blades of the Shogun",488000,610000,122000,39.99,25,60,15.99
"526",526,"X-COM: Interceptor",49000,608000,559000,4.99,1140.82,75,1.24
"527",527,"Space Pirates and Zombies",597000,607000,10000,9.99,1.68,50,4.99
"528",528,"Resident Evil / biohazard HD REMASTER",517000,605000,88000,19.99,17.02,60,7.99
"529",529,"Flesh Eaters",568000,605000,37000,1.99,6.51,75,0.49
"530",530,"Commandos 3: Destination Berlin",512000,603000,91000,4.99,17.77,90,0.49
"531",531,"Viscera Cleanup Detail",503000,601000,98000,12.99,19.48,50,6.49
"532",532,"LEGO Star Wars - The Complete Saga",577000,6e+05,23000,19.99,3.99,65,6.99
"533",533,"The Vanishing of Ethan Carter",571000,598000,27000,19.99,4.73,85,2.99
"534",534,"Tricolour Lovestory",514000,597000,83000,1.99,16.15,60,0.79
"535",535,"BATTLETECH",414000,597000,183000,39.99,44.2,30,27.99
"536",536,"Hitman: Contracts",550000,596000,46000,8.99,8.36,75,2.24
"537",537,"Styx: Master of Shadows",554000,595000,41000,29.99,7.4,80,5.99
"538",538,"E.Y.E: Divine Cybermancy",590000,595000,5000,9.99,0.85,70,2.99
"539",539,"Kingdoms and Castles",553000,594000,41000,9.99,7.41,30,6.99
"540",540,"X-COM: Terror From the Deep",515000,592000,77000,4.99,14.95,75,1.24
"541",541,"X-COM: Apocalypse",545000,592000,47000,4.99,8.62,75,1.24
"542",542,"Hearts of Iron III",571000,592000,21000,9.99,3.68,75,2.49
"543",543,"STRIDER / ストライダー飛竜",480000,592000,112000,14.99,23.33,70,4.49
"544",544,"Serious Sam Double D XXL",577000,591000,14000,9.99,2.43,80,1.99
"545",545,"FINAL FANTASY X/X-2 HD Remaster",490000,589000,99000,29.99,20.2,50,14.99
"546",546,"Commandos: Behind Enemy Lines",560000,588000,28000,4.99,5,90,0.74
"547",547,"Hyper Light Drifter",548000,588000,40000,19.99,7.3,60,7.99
"548",548,"Fortified",492000,588000,96000,14.99,19.51,80,2.99
"549",549,"X3: Terran Conflict",453000,585000,132000,15.99,29.14,75,3.99
"550",550,"RollerCoaster Tycoon 2: Triple Thrill Pack",561000,584000,23000,9.99,4.1,66,3.39
"551",551,"Really Big Sky",576000,584000,8000,4.99,1.39,80,0.99
"552",552,"Democracy 3",581000,584000,3000,24.99,0.52,75,6.24
"553",553,"The Secret of Monkey Island: Special Edition",561000,583000,22000,9.99,3.92,66,3.39
"554",554,"Jamestown",579000,583000,4000,9.99,0.69,0,9.99
"555",555,"Prototype",540000,580000,40000,19.99,7.41,75,4.99
"556",556,"Giana Sisters: Twisted Dreams",570000,577000,7000,14.99,1.23,75,3.74
"557",557,"TEKKEN 7",449000,577000,128000,39.99,28.51,60,19.99
"558",558,"Magic 2014 — Duels of the Planeswalkers",571000,576000,5000,9.99,0.88,0,9.99
"559",559,"Master Levels for Doom II",488000,575000,87000,14.99,17.83,67,4.94
"560",560,"Fable Anniversary",537000,574000,37000,34.99,6.89,75,8.74
"561",561,"Furi",366000,573000,207000,19.99,56.56,70,5.99
"562",562,"Tiny and Big: Grandpa's Leftovers",568000,572000,4000,9.99,0.7,90,0.99
"563",563,"Guardians of Middle-earth",496000,572000,76000,19.99,15.32,0,19.99
"564",564,"Blackguards",540000,571000,31000,9.99,5.74,90,1.99
"565",565,"Tomb Raider V: Chronicles",549000,571000,22000,6.99,4.01,86,0.97
"566",566,"Shank 2",520000,567000,47000,9.99,9.04,75,2.49
"567",567,"Penumbra Overture",480000,567000,87000,9.99,18.13,85,1.49
"568",568,"Bayonetta",436000,567000,131000,19.99,30.05,66,6.79
"569",569,"FORCED: Slightly Better Edition",544000,566000,22000,14.99,4.04,85,2.24
"570",570,"Kivi, Toilet and Shotgun",511000,566000,55000,0.99,10.76,51,0.49
"571",571,"Syberia II",482000,566000,84000,12.99,17.43,70,3.89
"572",572,"Command & Conquer 3: Tiberium Wars",562000,564000,2000,14.99,0.36,75,3.74
"573",573,"Breath of Death VII",551000,562000,11000,2.99,2,83,0.5
"574",574,"RPG Maker VX Ace",424000,562000,138000,69.99,32.55,80,13.99
"575",575,"Lone Survivor: The Director's Cut",381000,561000,180000,14.99,47.24,40,8.99
"576",576,"Waveform",535000,561000,26000,1.99,4.86,75,0.49
"577",577,"A Story About My Uncle",553000,561000,8000,12.99,1.45,80,2.59
"578",578,"Sonic Adventure 2",534000,559000,25000,9.99,4.68,75,2.49
"579",579,"MX vs. ATV Reflex",538000,557000,19000,89.99,3.53,80,4.99
"580",580,"Polarity",491000,557000,66000,12.99,13.44,90,1.29
"581",581,"Cossacks 3",329000,556000,227000,19.99,69,60,7.99
"582",582,"Batman: Arkham Origins Blackgate - Deluxe Edition",549000,556000,7000,19.99,1.28,75,4.99
"583",583,"Blockstorm",409000,555000,146000,4.99,35.7,80,0.99
"584",584,"Mini Metro",459000,555000,96000,9.99,20.92,50,4.99
"585",585,"Deus Ex: The Fall",486000,554000,68000,9.99,13.99,80,1.99
"586",586,"Heaven Island Life",484000,553000,69000,0.99,14.26,30,0.69
"587",587,"Glass Masquerade",30000,549000,519000,4.99,1730,75,1.24
"588",588,"Wolfenstein II: The New Colossus",375000,546000,171000,59.99,45.6,67,19.79
"589",589,"Defense Grid: The Awakening",544000,546000,2000,9.99,0.37,75,2.49
"590",590,"Commandos: Beyond the Call of Duty",487000,544000,57000,4.99,11.7,90,0.49
"591",591,"Tom Clancy's Rainbow Six Vegas 2",491000,543000,52000,9.99,10.59,66,3.39
"592",592,"NBA 2K17",491000,542000,51000,59.99,10.39,0,59.99
"593",593,"Men of War: Assault Squad",515000,542000,27000,9.99,5.24,80,1.99
"594",594,"Lead and Gold: Gangs of the Wild West",517000,542000,25000,9.99,4.84,75,2.49
"595",595,"Call of Duty: Infinite Warfare",495000,542000,47000,59.99,9.49,67,19.79
"596",596,"Invasion: Brain Craving",476000,541000,65000,0.99,13.66,51,0.49
"597",597,"Victor Vran ARPG",493000,540000,47000,19.99,9.53,75,4.99
"598",598,"Empyrion - Galactic Survival",421000,540000,119000,19.99,28.27,50,9.99
"599",599,"STAR WARS: The Clone Wars - Republic Heroes",473000,538000,65000,19.99,13.74,66,6.79
"600",600,"Armello",450000,537000,87000,19.99,19.33,50,9.99
"601",601,"Wreckfest",518000,537000,19000,44.99,3.67,33,30.14
"602",602,"FaceRig",512000,535000,23000,14.99,4.49,50,7.49
"603",603,"Painkiller Hell & Damnation",440000,534000,94000,19.99,21.36,80,4.99
"604",604,"Worms Clan Wars",437000,534000,97000,24.99,22.2,80,4.99
"605",605,"GRAV",446000,531000,85000,19.99,19.06,65,6.99
"606",606,"The Bridge",442000,530000,88000,9.99,19.91,81,1.89
"607",607,"Sacred Citadel",526000,530000,4000,9.99,0.76,66,3.39
"608",608,"The Escapists 2",389000,530000,141000,19.99,36.25,50,9.99
"609",609,"Kingdom: New Lands",461000,529000,68000,14.99,14.75,80,2.99
"610",610,"Gothic 3",518000,527000,9000,9.99,1.74,75,2.49
"611",611,"Five Nights at Freddy's 2",510000,527000,17000,7.99,3.33,75,1.99
"612",612,"Red Faction II",460000,527000,67000,9.99,14.57,75,2.49
"613",613,"Sir, You Are Being Hunted",416000,527000,111000,19.99,26.68,80,3.99
"614",614,"Heaven Island - VR MMO",516000,527000,11000,0.99,2.13,37,0.62
"615",615,"Far Cry Primal",458000,526000,68000,49.99,14.85,75,12.49
"616",616,"Terra Incognita ~ Chapter One: The Descendant",483000,522000,39000,0.99,8.07,51,0.49
"617",617,"NightSky",517000,522000,5000,9.99,0.97,67,3.29
"618",618,"This Is the Police",426000,522000,96000,14.99,22.54,75,3.74
"619",619,"Osmos",510000,522000,12000,9.99,2.35,70,2.99
"620",620,"Broken Age",515000,522000,7000,14.99,1.36,80,3.74
"621",621,"THE KING OF FIGHTERS XIII STEAM EDITION",496000,521000,25000,19.99,5.04,75,4.99
"622",622,"ARMA: Gold Edition",497000,521000,24000,9.99,4.83,80,1.99
"623",623,"Tales of Zestiria",439000,520000,81000,49.99,18.45,75,12.49
"624",624,"Alpha Protocol",511000,519000,8000,14.99,1.57,90,1.49
"625",625,"Wasteland 1 - The Original Classic",348000,517000,169000,5.99,48.56,50,2.99
"626",626,"Murder Miners",479000,516000,37000,0.99,7.72,51,0.49
"627",627,"Homefront: The Revolution",453000,515000,62000,29.99,13.69,75,7.49
"628",628,"Baldur's Gate II: Enhanced Edition",457000,512000,55000,19.99,12.04,75,4.99
"629",629,"Septerra Core",405000,511000,106000,4.99,26.17,83,0.84
"630",630,"Garfield Kart",43000,511000,468000,4.99,1088.37,80,0.99
"631",631,"Hellblade: Senua's Sacrifice",322000,508000,186000,29.99,57.76,50,14.99
"632",632,"Princess.Loot.Pixel.Again",314000,507000,193000,4.99,61.46,75,1.24
"633",633,"Car Mechanic Simulator 2014",494000,506000,12000,6.99,2.43,90,0.69
"634",634,"Revolution Ace",495000,504000,9000,4.99,1.82,75,1.24
"635",635,"FlatOut 2",422000,504000,82000,9.99,19.43,90,0.99
"636",636,"Steep",238000,501000,263000,29.99,110.5,70,8.99
"637",637,"Offworld Trading Company",431000,5e+05,69000,19.99,16.01,50,9.99
"638",638,"SteamWorld Dig",493000,5e+05,7000,9.99,1.42,67,3.29
"639",639,"NEKOPARA Vol. 2",459000,5e+05,41000,9.99,8.93,50,4.99
"640",640,"Hard Reset Extended Edition",443000,499000,56000,14.99,12.64,90,1.49
"641",641,"BIT.TRIP Presents... Runner2: Future Legend of Rhythm Alien",425000,499000,74000,14.99,17.41,67,4.94
"642",642,"Victoria II",458000,498000,40000,19.99,8.73,75,4.99
"643",643,"Super Mustache",460000,497000,37000,0.99,8.04,51,0.49
"644",644,"Nuclear Throne",479000,496000,17000,11.99,3.55,0,11.99
"645",645,"Farming Simulator 2013 Titanium Edition",403000,495000,92000,14.99,22.83,50,7.49
"646",646,"SUNLESS SEA",414000,492000,78000,18.99,18.84,66,6.45
"647",647,"Savage Lands",437000,491000,54000,9.99,12.36,60,3.99
"648",648,"Lup",478000,491000,13000,0.99,2.72,51,0.49
"649",649,"TrackMania² Stadium",387000,490000,103000,9.99,26.61,70,2.99
"650",650,"Freebie",432000,490000,58000,0.99,13.43,51,0.49
"651",651,"Shovel Knight: Treasure Trove",486000,490000,4000,24.99,0.82,20,19.99
"652",652,"12 is Better Than 6",287000,490000,203000,9.99,70.73,77,2.29
"653",653,"Shadow of the Tomb Raider",0,489000,489000,59.99,0,50,29.99
"654",654,"Reign Of Kings",426000,488000,62000,9.99,14.55,90,1.99
"655",655,"Turmoil",427000,488000,61000,9.99,14.29,50,4.99
"656",656,"Shadowgrounds Survivor",467000,488000,21000,9.99,4.5,85,1.49
"657",657,"SimplePlanes",447000,487000,40000,12.99,8.95,50,6.49
"658",658,"Rebel Galaxy",424000,487000,63000,19.99,14.86,80,3.99
"659",659,"Blackwake",387000,486000,99000,19.99,25.58,55,8.99
"660",660,"Super Mega Neo Pug",432000,486000,54000,0.99,12.5,51,0.49
"661",661,"The Tower Of Elements",4e+05,485000,85000,0.99,21.25,51,0.49
"662",662,"Rivals of Aether",411000,485000,74000,14.99,18,70,4.49
"663",663,"Recettear: An Item Shop's Tale",478000,485000,7000,19.99,1.46,75,4.99
"664",664,"60 Seconds!",276000,485000,209000,9.99,75.72,75,2.49
"665",665,"Thief II: The Metal Age",474000,485000,11000,6.99,2.32,86,0.97
"666",666,"Invisible, Inc.",456000,484000,28000,19.99,6.14,75,4.99
"667",667,"Botanicula",429000,483000,54000,9.99,12.59,70,2.99
"668",668,"Scania Truck Driving Simulator",442000,483000,41000,9.99,9.28,90,0.99
"669",669,"Life is Strange: Before the Storm",390000,482000,92000,16.99,23.59,70,5.09
"670",670,"Aliens: Colonial Marines Collection",449000,481000,32000,29.99,7.13,90,2.99
"671",671,"Russian Horror Story",263000,479000,216000,7.99,82.13,90,0.79
"672",672,"Dungeon Siege II",439000,478000,39000,6.99,8.88,86,0.97
"673",673,"Never Alone (Kisima Ingitchuna)",468000,478000,10000,14.99,2.14,80,2.99
"674",674,"Sonic CD",403000,478000,75000,4.99,18.61,75,1.24
"675",675,"Cook, Serve, Delicious!",476000,478000,2000,9.99,0.42,80,1.99
"676",676,"Overgrowth",463000,474000,11000,29.99,2.38,40,17.99
"677",677,"Monkey Island 2 Special Edition: LeChuck’s Revenge",376000,474000,98000,9.99,26.06,66,3.39
"678",678,"Valiant Hearts: The Great War / Soldats Inconnus : Mémoires de la Grande Guerre",398000,474000,76000,14.99,19.1,66,5.09
"679",679,"Sniper Elite",437000,473000,36000,7.99,8.24,75,1.99
"680",680,"Robot Roller-Derby Disco Dodgeball",272000,473000,201000,9.99,73.9,80,1.99
"681",681,"The Guild II Renaissance",444000,472000,28000,9.99,6.31,75,2.49
"682",682,"The Last Hope",413000,472000,59000,1.99,14.29,75,0.49
"683",683,"Rock of Ages",460000,470000,10000,9.99,2.17,80,1.99
"684",684,"Strike Suit Zero",388000,470000,82000,19.99,21.13,80,3.99
"685",685,"Alien Breed 2: Assault",417000,470000,53000,9.99,12.71,85,1.49
"686",686,"The Basement Collection",378000,469000,91000,3.99,24.07,87,0.51
"687",687,"UnEpic",458000,469000,11000,12.99,2.4,70,3.89
"688",688,"Braveland",63000,468000,405000,4.99,642.86,70,1.49
"689",689,"Yellow: The Yellow Artifact",357000,467000,110000,0.99,30.81,51,0.49
"690",690,"100% Orange Juice",418000,466000,48000,6.99,11.48,75,1.74
"691",691,"Primal Carnage",420000,466000,46000,7.99,10.95,80,1.59
"692",692,"Street Racing Syndicate",420000,465000,45000,2.99,10.71,70,0.89
"693",693,"The Note",146000,464000,318000,5.99,217.81,70,1.79
"694",694,"Cities XL Platinum",457000,464000,7000,9.99,1.53,75,2.49
"695",695,"Q.U.B.E: Director's Cut",416000,464000,48000,9.99,11.54,75,2.49
"696",696,"Day of the Tentacle Remastered",442000,463000,21000,14.99,4.75,70,4.49
"697",697,"Kane and Lynch: Dead Men",422000,463000,41000,6.99,9.72,86,0.97
"698",698,"Memoria",388000,462000,74000,39.99,19.07,90,1.99
"699",699,"Jagged Alliance 2 - Wildfire",333000,461000,128000,6.99,38.44,80,1.39
"700",700,"Her Story",441000,461000,20000,5.99,4.54,60,2.39
"701",701,"LOST PLANET 3",399000,460000,61000,24.99,15.29,80,4.99
"702",702,"Catch a Falling Star",439000,460000,21000,0.99,4.78,51,0.49
"703",703,"Stellar 2D",418000,459000,41000,0.99,9.81,51,0.49
"704",704,"War for the Overworld",309000,458000,149000,29.99,48.22,80,6
"705",705,"Chaos on Deponia",432000,458000,26000,19.99,6.02,90,1.99
"706",706,"Hacker Evolution",436000,458000,22000,4.99,5.05,80,0.99
"707",707,"Unreal Tournament 2004: Editor's Choice Edition",448000,457000,9000,14.99,2.01,66,5.09
"708",708,"Talisman: Digital Edition",415000,456000,41000,6.99,9.88,70,2.39
"709",709,"Dead6hot",360000,456000,96000,0.99,26.67,51,0.49
"710",710,"Risen 3 - Titan Lords",429000,455000,26000,14.99,6.06,75,3.74
"711",711,"Edna & Harvey: Harvey's New Eyes",365000,454000,89000,39.99,24.38,90,1.99
"712",712,"Worms Crazy Golf",445000,450000,5000,9.99,1.12,80,1.99
"713",713,"McPixel",445000,450000,5000,4.99,1.12,80,0.99
"714",714,"QUAKE",438000,449000,11000,4.99,2.51,75,1.24
"715",715,"Golf It!",381000,448000,67000,8.99,17.59,45,4.94
"716",716,"A Virus Named TOM",361000,447000,86000,9.99,23.82,75,2.49
"717",717,"Pony Island",414000,446000,32000,4.99,7.73,67,1.64
"718",718,"Morphopolis",442000,446000,4000,3.99,0.9,80,0.79
"719",719,"Loot Hero DX",222000,446000,224000,2.99,100.9,80,0.59
"720",720,"Dark and Light",325000,445000,120000,29.99,36.92,50,14.99
"721",721,"Skyborn",427000,445000,18000,14.99,4.22,75,3.74
"722",722,"Invasion",322000,445000,123000,1.99,38.2,75,0.49
"723",723,"Assassin’s Creed Rogue",333000,443000,110000,19.99,33.03,60,7.99
"724",724,"Game of Thrones",415000,441000,26000,14.99,6.27,50,7.49
"725",725,"Galactic Civilizations I: Ultimate Edition",3e+05,440000,140000,9.99,46.67,80,1.99
"726",726,"ELEX",344000,439000,95000,49.99,27.62,60,19.99
"727",727,"My Time At Portia",231000,439000,208000,19.99,90.04,20,15.99
"728",728,"Dead Rising 2: Off the Record",413000,439000,26000,19.99,6.3,70,5.99
"729",729,"Sakura Spirit",399000,438000,39000,9.99,9.77,75,2.49
"730",730,"Shadow Warrior 2",379000,437000,58000,39.99,15.3,75,9.99
"731",731,"STAR WARS Galactic Battlegrounds Saga",395000,437000,42000,5.99,10.63,66,2.03
"732",732,"Bridge Constructor",405000,436000,31000,9.99,7.65,75,2.49
"733",733,"Atom Zombie Smasher",362000,436000,74000,9.99,20.44,66,3.39
"734",734,"Beyond Divinity",225000,436000,211000,5.99,93.78,90,0.59
"735",735,"Ampersand",429000,435000,6000,0.99,1.4,51,0.49
"736",736,"HunieCam Studio",379000,435000,56000,6.99,14.78,75,1.74
"737",737,"Heroes of Might & Magic V",398000,435000,37000,9.99,9.3,75,2.49
"738",738,"Nosferatu: The Wrath of Malachi",421000,434000,13000,2.99,3.09,70,0.89
"739",739,"Goodbye Deponia",346000,434000,88000,19.99,25.43,90,1.99
"740",740,"The Howler",385000,434000,49000,1.99,12.73,0,1.99
"741",741,"Owlboy",418000,433000,15000,24.99,3.59,50,12.49
"742",742,"Devil May Cry 4 Special Edition",342000,432000,90000,24.99,26.32,60,9.99
"743",743,"Clergy Splode",390000,432000,42000,0.99,10.77,51,0.49
"744",744,"Evoland",427000,430000,3000,9.99,0.7,75,2.49
"745",745,"Guacamelee! Super Turbo Championship Edition",417000,429000,12000,14.99,2.88,85,2.25
"746",746,"Street Fighter V",358000,428000,70000,19.99,19.55,60,7.99
"747",747,"Five Nights at Freddy's 3",4e+05,428000,28000,7.99,7,75,1.99
"748",748,"Alien Breed: Impact",423000,428000,5000,9.99,1.18,85,1.49
"749",749,"LEGO Harry Potter: Years 1-4",366000,427000,61000,19.99,16.67,75,4.99
"750",750,"Little Nightmares",292000,427000,135000,19.99,46.23,70,5.99
"751",751,"King's Bounty: Armored Princess",417000,427000,10000,9.99,2.4,80,1.99
"752",752,"Car Mechanic Simulator 2018",298000,425000,127000,19.99,42.62,45,10.99
"753",753,"Craft The World",376000,424000,48000,18.99,12.77,75,4.74
"754",754,"Calcu-Late",363000,424000,61000,0.99,16.8,51,0.49
"755",755,"DRAGON BALL XENOVERSE 2",370000,423000,53000,49.99,14.32,75,12.49
"756",756,"Drayt Empire",283000,421000,138000,0.99,48.76,51,0.49
"757",757,"LEGO Batman3: Beyond Gotham",392000,421000,29000,19.99,7.4,75,4.99
"758",758,"Star Saviors",370000,421000,51000,1.99,13.78,50,0.99
"759",759,"Tyranny",325000,420000,95000,29.99,29.23,66,14.99
"760",760,"Magicite",393000,420000,27000,9.99,6.87,50,4.99
"761",761,"One Piece Pirate Warriors 3",398000,419000,21000,39.99,5.28,75,9.99
"762",762,"DETOUR",409000,418000,9000,1.99,2.2,0,1.99
"763",763,"Grow Home",408000,417000,9000,7.99,2.21,75,1.99
"764",764,"The Incredible Adventures of Van Helsing II",394000,416000,22000,14.99,5.58,75,3.74
"765",765,"Neon Hardcorps",387000,415000,28000,0.99,7.24,51,0.49
"766",766,"Worms Pinball",395000,415000,20000,7.99,5.06,80,1.59
"767",767,"Half Minute Hero: Super Mega Neo Climax Ultimate Boy",412000,414000,2000,9.99,0.49,75,2.49
"768",768,"Tales of Berseria",304000,413000,109000,49.99,35.86,75,12.49
"769",769,"Clustertruck",289000,413000,124000,14.99,42.91,55,6.74
"770",770,"F1 2012",332000,412000,80000,19.99,24.1,75,4.99
"771",771,"FINAL FANTASY XIII-2",388000,411000,23000,19.99,5.93,50,9.99
"772",772,"Memories of a Vagabond",344000,411000,67000,4.99,19.48,70,1.49
"773",773,"Purgatory",353000,410000,57000,0.99,16.15,51,0.49
"774",774,"Organ Trail: Director's Cut",404000,410000,6000,4.99,1.49,50,2.49
"775",775,"The Whispered World Special Edition",384000,410000,26000,39.99,6.77,90,1.99
"776",776,"Quake III Arena",392000,409000,17000,14.99,4.34,50,7.49
"777",777,"Outlast 2",307000,409000,102000,29.99,33.22,75,7.49
"778",778,"Reigns",406000,409000,3000,2.99,0.74,50,1.49
"779",779,"Beat Saber",175000,409000,234000,19.99,133.71,0,19.99
"780",780,"Solar 2",366000,408000,42000,9.99,11.48,80,1.99
"781",781,"QUAKE III: Team Arena",332000,408000,76000,14.99,22.89,50,7.49
"782",782,"From Dust",371000,407000,36000,14.99,9.7,75,3.74
"783",783,"Tinboy",402000,406000,4000,1.99,1,51,0.49
"784",784,"Castlevania: Lords of Shadow – Ultimate Edition",383000,406000,23000,29.99,6.01,80,5.99
"785",785,"Stacking",401000,406000,5000,9.99,1.25,85,1.49
"786",786,"Journey To The Center Of The Earth",323000,405000,82000,0.99,25.39,51,0.49
"787",787,"Deep Rock Galactic",179000,404000,225000,24.99,125.7,30,17.49
"788",788,"Oddworld: Abe's Exoddus",317000,404000,87000,2.99,27.44,75,0.74
"789",789,"Osiris: New Dawn",337000,404000,67000,24.99,19.88,50,12.49
"790",790,"Manhunt",267000,403000,136000,9.99,50.94,65,3.49
"791",791,"Gothic 1",387000,403000,16000,19.99,4.13,80,3.99
"792",792,"Cosmic Dust & Rust",211000,403000,192000,0.99,91,51,0.49
"793",793,"Penumbra: Black Plague Gold Edition",390000,402000,12000,9.99,3.08,85,1.49
"794",794,"Atonement: Scourge of Time",354000,402000,48000,8.99,13.56,90,0.89
"795",795,"DYNASTY WARRIORS 9 真・三國無双８",169000,402000,233000,59.99,137.87,40,35.99
"796",796,"Windward",381000,401000,20000,9.99,5.25,65,3.49
"797",797,"Bejeweled 3",326000,4e+05,74000,4.99,22.7,75,1.24
"798",798,"Oxenfree",357000,4e+05,43000,19.99,12.04,75,4.99
"799",799,"Mountain",379000,4e+05,21000,0.99,5.54,51,0.49
"800",800,"Life is Feudal: Your Own",371000,399000,28000,19.99,7.55,60,7.99
"801",801,"Eaten Alive",320000,397000,77000,0.99,24.06,51,0.49
"802",802,"Despair",348000,397000,49000,0.99,14.08,51,0.49
"803",803,"Five Nights at Freddy's: Sister Location",374000,397000,23000,7.99,6.15,75,1.99
"804",804,"Nuclear Dawn",385000,396000,11000,9.99,2.86,85,1.49
"805",805,"World War 3",0,396000,396000,28,0,10,25.2
"806",806,"Nioh: Complete Edition / 仁王 Complete Edition",311000,395000,84000,49.99,27.01,50,24.99
"807",807,"Closure",321000,395000,74000,9.99,23.05,90,0.99
"808",808,"ArcaniA",385000,395000,10000,19.99,2.6,80,4.99
"809",809,"The Beginner's Guide",361000,395000,34000,9.99,9.42,75,2.49
"810",810,"Ticket to Ride",359000,395000,36000,9.99,10.03,60,3.99
"811",811,"One Way Heroics",341000,395000,54000,3.49,15.84,50,1.74
"812",812,"Bionic Commando: Rearmed",382000,394000,12000,9.99,3.14,80,1.99
"813",813,"New kind of adventure",390000,392000,2000,0.99,0.51,51,0.49
"814",814,"Crazy Taxi",338000,392000,54000,7.99,15.98,85,1.19
"815",815,"Five Nights at Freddy's 4",185000,391000,206000,7.99,111.35,75,1.99
"816",816,"DLC Quest",381000,389000,8000,2.99,2.1,50,1.49
"817",817,"Hyperdimension Neptunia Re;Birth1 / 超次次元ゲイム ネプテューヌRe;Birth1 / 超次次元遊戲戰機少女重生1",329000,389000,60000,24.99,18.24,85,4.49
"818",818,"Vertiginous Golf",381000,389000,8000,9.99,2.1,90,0.99
"819",819,"Sniper Elite: Nazi Zombie Army 2",299000,388000,89000,14.99,29.77,75,3.74
"820",820,"Star Chronicles: Delta Quadrant",382000,388000,6000,0.99,1.57,51,0.49
"821",821,"Squishy the Suicidal Pig",327000,387000,60000,5.99,18.35,0,1.99
"822",822,"X3: Reunion",368000,387000,19000,9.99,5.16,66,3.39
"823",823,"Slender: The Arrival",381000,386000,5000,9.99,1.31,85,1.49
"824",824,"Universe Sandbox ²",321000,386000,65000,24.99,20.25,40,14.99
"825",825,"Condemned: Criminal Origins",227000,385000,158000,14.95,69.6,75,3.73
"826",826,"Tesla Effect: A Tex Murphy Adventure",366000,385000,19000,19.99,5.19,80,3.99
"827",827,"The Crew",364000,385000,21000,29.99,5.77,75,7.49
"828",828,"EDGE",336000,384000,48000,6.99,14.29,90,0.69
"829",829,"King's Bounty: Crossworlds",264000,382000,118000,14.99,44.7,75,3.74
"830",830,"Greyfox RPG",325000,382000,57000,1.99,17.54,83,0.49
"831",831,"Canyon Capers",366000,382000,16000,6.99,4.37,90,0.69
"832",832,"Party Hard",367000,382000,15000,12.89,4.09,75,3.22
"833",833,"Men of War",365000,382000,17000,4.99,4.66,75,1.24
"834",834,"The Night of the Rabbit",368000,381000,13000,39.99,3.53,90,1.99
"835",835,"Legend of Mysteria RPG",308000,381000,73000,1.99,23.7,84,0.49
"836",836,"Crystals of Time",371000,380000,9000,1.99,2.43,50,0.99
"837",837,"Pixel Puzzles: Japan",336000,380000,44000,6.99,13.1,85,1.04
"838",838,"Need for Speed Undercover",354000,380000,26000,9.99,7.34,75,2.49
"839",839,"Hero Quest: Tower Conflict",351000,380000,29000,0.99,8.26,51,0.49
"840",840,"The Room",319000,380000,61000,4.99,19.12,75,1.24
"841",841,"Make it indie!",342000,380000,38000,0.99,11.11,51,0.49
"842",842,"FINAL FANTASY IX",344000,379000,35000,20.99,10.17,40,12.59
"843",843,"Samorost 2",324000,379000,55000,4.99,16.98,70,1.49
"844",844,"Street Warriors Online",368000,377000,9000,1.99,2.45,0,1.99
"845",845,"Dead Island Definitive Edition",304000,377000,73000,19.99,24.01,75,4.99
"846",846,"Fallen Enchantress: Legendary Heroes",308000,375000,67000,24.99,21.75,60,9.99
"847",847,"Shower With Your Dad Simulator 2015: Do You Still Shower With Your Dad",362000,375000,13000,0.99,3.59,30,0.69
"848",848,"RADical ROACH Remastered",364000,374000,10000,2.99,2.75,75,0.74
"849",849,"The Incredible Adventures of Van Helsing: Final Cut",297000,374000,77000,44.99,25.93,75,11.24
"850",850,"Shadow Warrior Classic Redux",324000,374000,50000,9.99,15.43,75,2.49
"851",851,"Momodora: Reverie Under The Moonlight",354000,373000,19000,9.99,5.37,80,2
"852",852,"Construction Simulator 2015",356000,371000,15000,14.99,4.21,60,5.99
"853",853,"Wolfenstein 3D",298000,371000,73000,4.99,24.5,75,1.24
"854",854,"Legacy of Kain: Soul Reaver",344000,371000,27000,6.99,7.85,86,0.97
"855",855,"SAMOLIOTIK",239000,371000,132000,0.99,55.23,45,0.54
"856",856,"ibb & obb",349000,370000,21000,11.99,6.02,70,3.59
"857",857,"Human Resource Machine",291000,370000,79000,9.99,27.15,50,4.99
"858",858,"Aquaria",347000,369000,22000,9.99,6.34,75,2.49
"859",859,"Battlestations: Midway",311000,368000,57000,6.99,18.33,86,0.97
"860",860,"POSTAL",337000,368000,31000,1.99,9.2,75,0.49
"861",861,"Tom Clancy's Splinter Cell Chaos Theory",352000,367000,15000,9.99,4.26,66,3.39
"862",862,"Unforgiving Trials: The Darkest Crusade",272000,367000,95000,0.99,34.93,51,0.49
"863",863,"R.A.W. Realms of Ancient War",307000,367000,60000,14.99,19.54,85,2.24
"864",864,"LUFTRAUSERS",359000,366000,7000,9.99,1.95,75,2.49
"865",865,"Unforgiving Trials: The Space Crusade",295000,366000,71000,0.99,24.07,51,0.49
"866",866,"Sakura Angels",236000,366000,130000,9.99,55.08,70,2.99
"867",867,"Tower Wars",337000,366000,29000,7.99,8.61,0,7.99
"868",868,"Super Space Pug",267000,365000,98000,0.99,36.7,51,0.49
"869",869,"DRAGON BALL FighterZ",227000,363000,136000,59.99,59.91,60,23.99
"870",870,"LEGO Jurassic World",268000,363000,95000,19.99,35.45,75,4.99
"871",871,"The Dark Eye: Chains of Satinav",295000,363000,68000,19.99,23.05,90,1.99
"872",872,"Long Live The Queen",226000,362000,136000,9.99,60.18,60,3.99
"873",873,"Resident Evil 0 / biohazard 0 HD REMASTER",334000,362000,28000,19.99,8.38,60,7.99
"874",874,"A New Beginning - Final Cut",342000,362000,20000,9.99,5.85,90,0.99
"875",875,"Halo: Spartan Assault",354000,361000,7000,2.99,1.98,60,1.19
"876",876,"Chaos Domain",356000,361000,5000,9.99,1.4,90,0.99
"877",877,"Bit Blaster XL",319000,360000,41000,0.99,12.85,51,0.49
"878",878,"Crawl",288000,360000,72000,14.99,25,50,7.49
"879",879,"Transport Fever",267000,359000,92000,34.99,34.46,60,13.99
"880",880,"Intrusion 2",352000,359000,7000,9.99,1.99,80,1.99
"881",881,"Minecraft: Story Mode - A Telltale Games Series",293000,358000,65000,24.99,22.18,70,7.49
"882",882,"Anomaly 2",246000,358000,112000,14.99,45.53,85,2.24
"883",883,"Caster",354000,358000,4000,1.99,1.13,0,1.99
"884",884,"IL-2 Sturmovik: 1946",321000,358000,37000,9.99,11.53,75,2.49
"885",885,"Realms of the Haunting",327000,357000,30000,2.99,9.17,70,0.89
"886",886,"Data Hacker: Reboot",270000,357000,87000,4.99,32.22,90,0.49
"887",887,"Legend of Grimrock 2",308000,356000,48000,23.99,15.58,60,9.59
"888",888,"VA-11 Hall-A: Cyberpunk Bartender Action",279000,356000,77000,14.99,27.6,34,9.89
"889",889,"Batman - The Telltale Series",310000,355000,45000,14.99,14.52,60,9.99
"890",890,"State of Decay: YOSE",323000,354000,31000,29.99,9.6,75,7.49
"891",891,"Project Starship",292000,354000,62000,0.99,21.23,51,0.49
"892",892,"Mercenary Kings: Reloaded Edition",351000,353000,2000,19.99,0.57,50,9.99
"893",893,"Bacteria",226000,353000,127000,0.99,56.19,51,0.49
"894",894,"Turbo Dismount",340000,353000,13000,9.99,3.82,70,2.99
"895",895,"RUNNING WITH RIFLES",258000,353000,95000,14.99,36.82,70,4.49
"896",896,"Sleeping Valley",290000,352000,62000,10.99,21.38,87,0.64
"897",897,"Minimalism",179000,351000,172000,0.99,96.09,51,0.49
"898",898,"LEGO Harry Potter: Years 5-7",235000,351000,116000,19.99,49.36,75,4.99
"899",899,"The LEGO Movie - Videogame",345000,350000,5000,19.99,1.45,75,4.99
"900",900,"Vessel",341000,350000,9000,19.99,2.64,75,4.99
"901",901,"Command & Conquer 4: Tiberian Twilight",338000,350000,12000,19.99,3.55,75,4.99
"902",902,"Sherlock Holmes: The Devil's Daughter",274000,350000,76000,49.99,27.74,75,12.49
"903",903,"Energy Balance",277000,348000,71000,2.99,25.63,70,0.89
"904",904,"Timberman",335000,347000,12000,0.99,3.58,51,0.49
"905",905,"BATTALION 1944",314000,347000,33000,14.99,10.51,0,14.99
"906",906,"Lone Leader",248000,346000,98000,0.99,39.52,51,0.49
"907",907,"Kingdom Rush",340000,344000,4000,9.99,1.18,50,4.99
"908",908,"SteamWorld Heist",280000,344000,64000,14.99,22.86,67,4.94
"909",909,"Planetbase",282000,343000,61000,19.99,21.63,30,13.99
"910",910,"CONSORTIUM",334000,343000,9000,9.99,2.69,50,4.99
"911",911,"Grand Pigeon's Duty",205000,342000,137000,3.99,66.83,80,0.79
"912",912,"Screencheat",289000,342000,53000,14.99,18.34,66,5.09
"913",913,"Genital Jousting",267000,342000,75000,6.99,28.09,69,2.16
"914",914,"Final Quest",292000,341000,49000,0.99,16.78,51,0.49
"915",915,"RWBY: Grimm Eclipse",263000,341000,78000,19.99,29.66,75,4.99
"916",916,"Sacred 3",315000,341000,26000,14.99,8.25,75,3.74
"917",917,"LEGO STAR WARS: The Force Awakens",233000,338000,105000,29.99,45.06,75,7.49
"918",918,"Papo & Yo",298000,338000,40000,14.99,13.42,50,7.49
"919",919,"Guardians of Victoria",248000,338000,90000,1.99,36.29,75,0.49
"920",920,"Oil Rush",336000,338000,2000,7.99,0.6,0,7.99
"921",921,"Spikit",286000,338000,52000,0.99,18.18,51,0.49
"922",922,"Proteus",263000,337000,74000,9.99,28.14,50,4.99
"923",923,"Aragami",287000,336000,49000,19.99,17.07,60,7.99
"924",924,"Hacker Evolution: Untold",272000,335000,63000,4.99,23.16,80,0.99
"925",925,"Escape This",320000,335000,15000,0.99,4.69,37,0.62
"926",926,"Domina",228000,335000,107000,9.99,46.93,69,3.09
"927",927,"What Remains of Edith Finch",230000,334000,104000,19.99,45.22,50,9.99
"928",928,"$1 Ride",316000,334000,18000,0.98,5.7,50,0.49
"929",929,"Battlefleet Gothic: Armada",277000,333000,56000,29.99,20.22,75,7.49
"930",930,"There's Poop In My Soup",284000,333000,49000,0.99,17.25,51,0.49
"931",931,"Material Girl",265000,333000,68000,1.99,25.66,70,0.59
"932",932,"FlatOut: Ultimate Carnage",331000,333000,2000,19.99,0.6,80,3.99
"933",933,"Deep Space Dash",302000,332000,30000,0.99,9.93,51,0.49
"934",934,"King Arthur's Gold",328000,332000,4000,9.99,1.22,75,2.49
"935",935,"Oddworld: New 'n' Tasty",316000,332000,16000,19.99,5.06,75,4.99
"936",936,"LIGHTNING RETURNS: FINAL FANTASY XIII",321000,331000,10000,19.99,3.12,50,9.99
"937",937,"Grey Goo",326000,331000,5000,29.99,1.53,75,7.49
"938",938,"Sniper Ghost Warrior 3",226000,331000,105000,19.99,46.46,55,12.79
"939",939,"South Park: The Fractured But Whole",276000,330000,54000,59.99,19.57,75,14.99
"940",940,"Ionball 2: Ionstorm",315000,330000,15000,4.99,4.76,90,0.49
"941",941,"Gish",314000,329000,15000,9.99,4.78,0,9.99
"942",942,"The Turing Test",285000,328000,43000,19.99,15.09,80,3.99
"943",943,"For The King",248000,328000,80000,19.99,32.26,50,9.99
"944",944,"A grande bagunça espacial - The big space mess",285000,327000,42000,0.99,14.74,51,0.49
"945",945,"My Summer Car",317000,327000,10000,14.99,3.15,0,14.99
"946",946,"Infested Planet",255000,327000,72000,14.99,28.24,75,3.74
"947",947,"The Guild II - Pirates of the European Seas",262000,326000,64000,9.99,24.43,75,2.49
"948",948,"QUAKE Mission Pack 1: Scourge of Armagon",72000,326000,254000,2.99,352.78,40,1.79
"949",949,"Mother Russia Bleeds",220000,325000,105000,14.99,47.73,75,3.74
"950",950,"From the Depths",224000,325000,101000,14.99,45.09,80,3.99
"951",951,"TIS-100",285000,325000,40000,6.99,14.04,75,1.74
"952",952,"Dream Daddy: A Dad Dating Simulator",285000,324000,39000,14.99,13.68,50,7.49
"953",953,"BitRay",234000,324000,90000,0.99,38.46,51,0.49
"954",954,"Overhell",296000,323000,27000,1.99,9.12,75,0.49
"955",955,"Detention",231000,323000,92000,11.99,39.83,60,4.79
"956",956,"The Banner Saga 2",241000,323000,82000,24.99,34.02,66,6.79
"957",957,"Turbo Pug 3D",306000,323000,17000,1.99,5.56,50,0.99
"958",958,"Dragon Cliff",81000,322000,241000,9.99,297.53,40,5.99
"959",959,"DEEP SPACE WAIFU",246000,321000,75000,1.99,30.49,40,1.19
"960",960,"Hydrophobia: Prophecy",315000,321000,6000,4.99,1.9,0,4.99
"961",961,"Alien Breed 3: Descent",311000,321000,10000,9.99,3.22,85,1.49
"962",962,"LISA",293000,319000,26000,9.99,8.87,50,4.99
"963",963,"Bridge Constructor Portal",112000,319000,207000,9.99,184.82,50,4.99
"964",964,"Arma Tactics",214000,319000,105000,8.99,49.07,80,1.79
"965",965,"Germ Wars",287000,319000,32000,0.99,11.15,51,0.49
"966",966,"Hostile Waters: Antaeus Rising",227000,319000,92000,2.99,40.53,70,0.89
"967",967,"Zeno Clash 2",306000,318000,12000,14.99,3.92,80,2.99
"968",968,"Gods Will Be Watching",302000,318000,16000,9.99,5.3,75,2.49
"969",969,"Battlestations Pacific",294000,317000,23000,8.99,7.82,89,0.98
"970",970,"gravilon",312000,316000,4000,2.99,1.28,0,2.99
"971",971,"Unknown Battle",299000,315000,16000,3.99,5.35,87,0.51
"972",972,"It's Spring Again",255000,315000,60000,0.99,23.53,51,0.49
"973",973,"Medieval Engineers",295000,315000,20000,19.99,6.78,60,7.99
"974",974,"Sword Art Online: Fatal Bullet",142000,315000,173000,49.99,121.83,60,19.99
"975",975,"DYNASTY WARRIORS 8: Xtreme Legends Complete Edition / 真・三國無双７ with 猛将伝",284000,315000,31000,49.99,10.92,70,14.99
"976",976,"Under Zero",290000,315000,25000,3.99,8.62,87,0.51
"977",977,"Melissa K. and the Heart of Gold Collector's Edition",245000,314000,69000,9.99,28.16,90,0.99
"978",978,"Hyper color ball",284000,314000,30000,0.99,10.56,51,0.49
"979",979,"Ampu-Tea",252000,314000,62000,4.99,24.6,85,0.74
"980",980,"NARUTO SHIPPUDEN: Ultimate Ninja STORM Revolution",303000,314000,11000,29.99,3.63,75,7.49
"981",981,"QUAKE II Mission Pack: The Reckoning",57000,314000,257000,2.99,450.88,40,1.79
"982",982,"Nation Red",296000,313000,17000,1.99,5.74,66,0.67
"983",983,"Command & Conquer 3: Kane's Wrath",3e+05,313000,13000,19.99,4.33,75,4.99
"984",984,"FEMINAZI: The Triggering",242000,313000,71000,0.99,29.34,51,0.49
"985",985,"Interstellar Marines",238000,313000,75000,9.99,31.51,50,4.99
"986",986,"LARA CROFT AND THE TEMPLE OF OSIRIS",283000,313000,30000,19.99,10.6,85,2.99
"987",987,"Streets of Rogue",255000,313000,58000,14.99,22.75,40,8.99
"988",988,"The 39 Steps",301000,312000,11000,14.99,3.65,90,1.49
"989",989,"The Jackbox Party Pack 3",254000,312000,58000,24.99,22.83,50,12.49
"990",990,"Penny Arcade's On the Rain-Slick Precipice of Darkness 3",254000,312000,58000,1.99,22.83,70,0.59
"991",991,"A Bird Story",303000,312000,9000,3.99,2.97,75,0.99
"992",992,"Warriors of Vilvatikta",302000,312000,10000,0.99,3.31,51,0.49
"993",993,"Legacy of Kain: Soul Reaver 2",303000,311000,8000,6.99,2.64,86,0.97
"994",994,"The Testament of Sherlock Holmes",291000,311000,20000,19.99,6.87,75,4.99
"995",995,"Forts",258000,311000,53000,14.99,20.54,40,8.99
"996",996,"EeOneGuy Adventure",270000,310000,40000,0.99,14.81,51,0.49
"997",997,"Just Hero",240000,310000,70000,0.99,29.17,51,0.49
"998",998,"Commando Jack",255000,310000,55000,7.99,21.57,75,1.99
"999",999,"Flix and Chill",190000,309000,119000,0.99,62.63,51,0.49
"1000",1000,"Tooth and Tail",149000,309000,160000,19.99,107.38,75,4.99
"1001",1001,"PAC-MAN Championship Edition DX+",283000,309000,26000,9.99,9.19,75,3.74
"1002",1002,"Millennium - A New Hope",214000,309000,95000,5.99,44.39,90,0.59
"1003",1003,"Betrayer",153000,308000,155000,4.99,101.31,80,0.99
"1004",1004,"Space Pilgrim Episode I: Alpha Centauri",263000,308000,45000,1.99,17.11,75,0.49
"1005",1005,"SkyTime",233000,307000,74000,0.99,31.76,51,0.49
"1006",1006,"Sheltered",238000,306000,68000,14.99,28.57,75,3.74
"1007",1007,"Epistory - Typing Chronicles",291000,306000,15000,14.99,5.15,67,4.94
"1008",1008,"Alpha Prime",3e+05,306000,6000,4.99,2,80,0.99
"1009",1009,"A Hat in Time",164000,306000,142000,29.99,86.59,42,17.39
"1010",1010,"Legacy of Kain: Defiance",261000,305000,44000,6.99,16.86,86,0.97
"1011",1011,"Energy Cycle",256000,304000,48000,2.99,18.75,65,1.04
"1012",1012,"Bloons TD 5",262000,304000,42000,9.99,16.03,50,4.99
"1013",1013,"Broken Sword: Director's Cut",295000,304000,9000,5.99,3.05,60,2.39
"1014",1014,"Wurm Unlimited",229000,304000,75000,29.99,32.75,70,8.99
"1015",1015,"Jazzpunk: Director's Cut",295000,303000,8000,14.99,2.71,80,2.99
"1016",1016,"Divinity: Dragon Commander",219000,303000,84000,39.99,38.36,90,3.99
"1017",1017,"Devil Daggers",288000,302000,14000,4.99,4.86,60,1.99
"1018",1018,"STAR WARS - X-Wing Alliance",271000,302000,31000,9.99,11.44,65,3.49
"1019",1019,"Red Lake",284000,302000,18000,0.99,6.34,51,0.49
"1020",1020,"SpellForce 2: Faith in Destiny",238000,301000,63000,14.99,26.47,80,2.99
"1021",1021,"Labyronia RPG 2",271000,3e+05,29000,1.99,10.7,83,0.49
"1022",1022,"Project Highrise",277000,3e+05,23000,19.99,8.3,75,4.99
"1023",1023,"Kentucky Route Zero",295000,3e+05,5000,24.99,1.69,70,7.49
"1024",1024,"Rise of the Ancients",246000,3e+05,54000,0.99,21.95,51,0.49
"1025",1025,"Tales of Symphonia",276000,299000,23000,19.99,8.33,75,4.99
"1026",1026,"Sparkle 2 Evo",287000,299000,12000,4.99,4.18,90,0.49
"1027",1027,"Mordheim: City of the Damned",214000,299000,85000,39.99,39.72,75,9.99
"1028",1028,"Snowman",287000,299000,12000,0.99,4.18,51,0.49
"1029",1029,"The Silent Age",270000,299000,29000,9.99,10.74,90,0.99
"1030",1030,"SweatShop",199000,299000,1e+05,0.99,50.25,51,0.49
"1031",1031,"Star Drifter",282000,299000,17000,0.99,6.03,51,0.49
"1032",1032,"Stonehearth",223000,299000,76000,19.99,34.08,0,19.99
"1033",1033,"QUAKE II Mission Pack: Ground Zero",37000,298000,261000,2.99,705.41,40,1.79
"1034",1034,"Chroma Squad",251000,298000,47000,14.99,18.73,50,7.49
"1035",1035,"Nyctophobia",273000,298000,25000,1.99,9.16,0,1.99
"1036",1036,"State of Anarchy",264000,297000,33000,0.99,12.5,51,0.49
"1037",1037,"Worms Blast",125000,297000,172000,7.99,137.6,80,1.59
"1038",1038,"VITATIO 2",201000,297000,96000,0.99,47.76,51,0.49
"1039",1039,"Abyss Odyssey",293000,297000,4000,14.99,1.37,80,2.99
"1040",1040,"Broken Dreams",285000,297000,12000,1.99,4.21,75,0.49
"1041",1041,"STAR WARS X-Wing vs TIE Fighter - Balance of Power Campaigns",279000,296000,17000,9.99,6.09,65,3.49
"1042",1042,"Puzzle Galaxies",101000,296000,195000,0.99,193.07,51,0.49
"1043",1043,"LYNE",277000,295000,18000,2.99,6.5,70,0.89
"1044",1044,"Star Fields",263000,295000,32000,0.99,12.17,51,0.49
"1045",1045,"Home",292000,295000,3000,2.99,1.03,66,1.01
"1046",1046,"Platypus II",283000,294000,11000,6.99,3.89,90,0.69
"1047",1047,"Dark Elf",160000,294000,134000,3.99,83.75,70,1.19
"1048",1048,"Oh...Sir!! The Insult Simulator",235000,293000,58000,1.99,24.68,70,0.59
"1049",1049,"Tom Clancy's Ghost Recon: Future Soldier",285000,293000,8000,19.99,2.81,66,6.79
"1050",1050,"Super Killer Hornet: Resurrection",272000,293000,21000,4.99,7.72,85,0.74
"1051",1051,"Into the Breach",191000,292000,101000,14.99,52.88,33,10.04
"1052",1052,"Final Quest II",254000,292000,38000,0.99,14.96,51,0.49
"1053",1053,"Uriel's Chasm",273000,292000,19000,4.99,6.96,85,0.74
"1054",1054,"The Typing of The Dead: Overkill",282000,292000,10000,19.99,3.55,0,19.99
"1055",1055,"Snapshot",245000,292000,47000,9.99,19.18,40,5.99
"1056",1056,"God Mode",282000,292000,10000,9.99,3.55,80,1.99
"1057",1057,"Earth 2140",261000,290000,29000,4.99,11.11,80,0.99
"1058",1058,"Vanguard Princess",275000,290000,15000,4.99,5.45,70,1.49
"1059",1059,"HITMAN 2",0,289000,289000,59.99,0,0,59.99
"1060",1060,"Magazime Editor",255000,289000,34000,0.99,13.33,51,0.49
"1061",1061,"Retention",286000,289000,3000,0.99,1.05,51,0.49
"1062",1062,"JumpBall",215000,288000,73000,1.99,33.95,75,0.49
"1063",1063,"Orbital Gear",285000,288000,3000,9.99,1.05,90,0.99
"1064",1064,"Else Heart.Break()",262000,288000,26000,24.99,9.92,75,6.24
"1065",1065,"Legendary",275000,287000,12000,1.99,4.36,83,0.5
"1066",1066,"Might & Magic: Clash of Heroes",261000,287000,26000,9.99,9.96,75,2.49
"1067",1067,"Football Manager 2019",0,287000,287000,49.99,0,10,44.99
"1068",1068,"Nuclear Contingency",273000,287000,14000,0.99,5.13,51,0.49
"1069",1069,"Agent Awesome",209000,286000,77000,1.99,36.84,50,0.99
"1070",1070,"The I of the Dragon",277000,285000,8000,6.99,2.89,87,0.9
"1071",1071,"NORTH",201000,285000,84000,1.99,41.79,65,0.69
"1072",1072,"Magic 2015 - Duels of the Planeswalkers",280000,284000,4000,9.99,1.43,0,9.99
"1073",1073,"State of Anarchy: Master of Mayhem",70000,284000,214000,1.99,305.71,75,0.49
"1074",1074,"Motorsport Manager",244000,284000,40000,34.99,16.39,75,8.74
"1075",1075,"Gunscape",234000,283000,49000,19.99,20.94,0,19.99
"1076",1076,"Lovely Planet",244000,283000,39000,5.99,15.98,50,2.99
"1077",1077,"Steel Invaders",277000,283000,6000,0.99,2.17,51,0.49
"1078",1078,"Hatoful Boyfriend",273000,283000,10000,9.99,3.66,75,2.49
"1079",1079,"Velvet Assassin",262000,283000,21000,1.99,8.02,85,0.5
"1080",1080,"Bus Driver",273000,283000,10000,7.99,3.66,90,0.79
"1081",1081,"The Legend of Heroes: Trails in the Sky",235000,283000,48000,19.99,20.43,50,9.99
"1082",1082,"NEKOPARA Vol. 3",257000,282000,25000,9.99,9.73,35,6.49
"1083",1083,"Omerta - City of Gangsters",275000,282000,7000,14.99,2.55,80,2.99
"1084",1084,"NBA 2K19",0,282000,282000,59.99,0,50,29.99
"1085",1085,"Spakoyno: Back to the USSR 2.0",262000,282000,20000,7.99,7.63,90,0.79
"1086",1086,"Volgarr the Viking",267000,281000,14000,9.99,5.24,80,1.99
"1087",1087,"The Lost Valley",269000,281000,12000,4.99,4.46,70,1.49
"1088",1088,"Trouble In The Manor",234000,281000,47000,0.99,20.09,51,0.49
"1089",1089,"Tom Clancy's Splinter Cell",256000,280000,24000,9.99,9.38,66,3.39
"1090",1090,"Sakura Swim Club",209000,280000,71000,9.99,33.97,65,3.49
"1091",1091,"Outrage",204000,280000,76000,3.99,37.25,87,0.51
"1092",1092,"Montaro",245000,280000,35000,0.99,14.29,30,0.69
"1093",1093,"City of Chains",210000,279000,69000,8.99,32.86,90,0.89
"1094",1094,"OR",216000,279000,63000,0.99,29.17,51,0.49
"1095",1095,"Ys Origin",203000,279000,76000,19.99,37.44,70,5.99
"1096",1096,"Quantum Conundrum",268000,279000,11000,8.99,4.1,89,0.98
"1097",1097,"Surviving Mars",130000,279000,149000,29.99,114.62,40,20.99
"1098",1098,"Broken Sword 2 - the Smoking Mirror: Remastered",226000,279000,53000,5.99,23.45,60,2.39
"1099",1099,"Yakuza 0",0,278000,278000,19.99,0,33,13.39
"1100",1100,"Hexoscope",217000,278000,61000,2.99,28.11,0,2.99
"1101",1101,"Worms W.M.D",247000,278000,31000,29.99,12.55,66,10.19
"1102",1102,"Disgaea PC / 魔界戦記ディスガイア PC",174000,278000,104000,14.99,59.77,65,5.24
"1103",1103,"Conclusion",199000,277000,78000,1.99,39.2,75,0.49
"1104",1104,"Two Point Hospital",0,277000,277000,34.99,0,10,31.49
"1105",1105,"Halo Wars: Definitive Edition",181000,277000,96000,19.99,53.04,50,9.99
"1106",1106,"Secret Of Magia",246000,277000,31000,1.99,12.6,84,0.49
"1107",1107,"Data Hacker: Initiation",246000,277000,31000,2.99,12.6,83,0.5
"1108",1108,"Darkness Assault",108000,277000,169000,0.99,156.48,75,0.49
"1109",1109,"Audiosurf 2",213000,277000,64000,14.99,30.05,67,4.94
"1110",1110,"Gridberd",264000,277000,13000,6.99,4.92,80,1.39
"1111",1111,"Alien Shooter",147000,277000,130000,4.99,88.44,90,0.49
"1112",1112,"The Ball",273000,277000,4000,9.99,1.47,80,1.99
"1113",1113,"Battle Chasers: Nightwar",141000,277000,136000,29.99,96.45,67,9.89
"1114",1114,"Downwell",273000,277000,4000,2.99,1.47,50,1.49
"1115",1115,"Starseed Pilgrim",227000,276000,49000,5.99,21.59,35,3.89
"1116",1116,"Graveyard Keeper",0,276000,276000,19.99,0,30,13.99
"1117",1117,"They Bleed Pixels",259000,276000,17000,9.99,6.56,80,1.99
"1118",1118,"Full Mojo Rampage",220000,276000,56000,12.99,25.45,50,6.49
"1119",1119,"hack_me",271000,275000,4000,3.99,1.48,87,0.51
"1120",1120,"Men of War: Red Tide",268000,275000,7000,4.99,2.61,80,0.99
"1121",1121,"Dreamfall Chapters",249000,275000,26000,24.99,10.44,75,6.24
"1122",1122,"LEGO Batman",267000,275000,8000,19.99,3,75,4.99
"1123",1123,"Zombie Zoeds",242000,274000,32000,0.99,13.22,83,0.49
"1124",1124,"8BitBoy",264000,274000,10000,11.99,3.79,90,1.19
"1125",1125,"Destiny Warriors RPG",263000,274000,11000,1.99,4.18,83,0.49
"1126",1126,"Sid Meier's Starships",271000,274000,3000,14.99,1.11,50,7.49
"1127",1127,"Heaven Forest - VR MMO",207000,273000,66000,0.99,31.88,0,0.99
"1128",1128,"Stealth Bastard Deluxe",263000,273000,10000,9.99,3.8,90,1.29
"1129",1129,"Hidden Folks",118000,273000,155000,7.99,131.36,55,3.59
"1130",1130,"Fran Bow",235000,272000,37000,14.99,15.74,75,3.74
"1131",1131,"Primal Carnage: Extinction",223000,271000,48000,12.99,21.52,80,2.59
"1132",1132,"Dead Effect",232000,271000,39000,4.99,16.81,80,0.99
"1133",1133,"CPUCores :: Maximize Your FPS",201000,270000,69000,14.99,34.33,51,7.34
"1134",1134,"TerraTech",206000,270000,64000,24.99,31.07,40,11.99
"1135",1135,"Oddworld: Stranger's Wrath HD",261000,269000,8000,9.99,3.07,75,2.49
"1136",1136,"The Jackbox Party Pack 2",214000,269000,55000,24.99,25.7,50,12.49
"1137",1137,"Call of Duty",261000,269000,8000,19.99,3.07,51,9.79
"1138",1138,"Magdalena",256000,269000,13000,2.99,5.08,83,0.5
"1139",1139,"Edna & Harvey: The Breakout",223000,268000,45000,14.99,20.18,90,1.49
"1140",1140,"Through Abandoned",80000,267000,187000,0.99,233.75,51,0.49
"1141",1141,"Dungetris",258000,267000,9000,4.99,3.49,60,1.99
"1142",1142,"Cobi Treasure Deluxe",250000,267000,17000,2.99,6.8,66,1.01
"1143",1143,"DreadOut",245000,267000,22000,14.99,8.98,90,1.49
"1144",1144,"RUINER",139000,267000,128000,19.99,92.09,60,7.99
"1145",1145,"METAL SLUG X",261000,267000,6000,7.99,2.3,50,3.99
"1146",1146,"NiGHTS Into Dreams",232000,266000,34000,7.99,14.66,85,1.19
"1147",1147,"Dungeon Creepster",19000,266000,247000,0.99,1300,51,0.49
"1148",1148,"Blood Bowl: Chaos Edition",246000,266000,20000,14.99,8.13,75,3.74
"1149",1149,"Avencast: Rise of the Mage",256000,265000,9000,9.99,3.52,90,0.99
"1150",1150,"Train Valley",237000,265000,28000,9.99,11.81,80,1.99
"1151",1151,"Faerie Solitaire",248000,264000,16000,9.99,6.45,90,0.99
"1152",1152,"Tower Unite",187000,264000,77000,14.99,41.18,30,10.49
"1153",1153,"Liveza: Death of the Earth",222000,263000,41000,2.99,18.47,75,0.74
"1154",1154,"Next Day: Survival",187000,263000,76000,9.99,40.64,60,3.99
"1155",1155,"Wuppo",186000,263000,77000,14.99,41.4,74,3.89
"1156",1156,"Death Road to Canada",234000,263000,29000,14.99,12.39,50,7.49
"1157",1157,"Breach & Clear",235000,263000,28000,14.99,11.91,90,1.49
"1158",1158,"Clickdraw Clicker",177000,263000,86000,0.99,48.59,51,0.49
"1159",1159,"DiRT 4",219000,262000,43000,59.99,19.63,80,11.99
"1160",1160,"Trump Simulator 2017",197000,262000,65000,0.99,32.99,51,0.49
"1161",1161,"Iron Sky: Invasion",170000,262000,92000,19.99,54.12,90,1.99
"1162",1162,"Red Death",227000,262000,35000,0.99,15.42,51,0.49
"1163",1163,"Defend Your Life: TD",218000,261000,43000,4.99,19.72,60,1.99
"1164",1164,"Pixel Puzzles 2: Anime",250000,261000,11000,9.99,4.4,85,1.49
"1165",1165,"Prince of Persia",254000,261000,7000,9.99,2.76,66,3.39
"1166",1166,"Pressured",246000,261000,15000,2.99,6.1,75,0.74
"1167",1167,"Frontlines: Fuel of War",255000,261000,6000,89.99,2.35,80,4.99
"1168",1168,"Wizard of Legend",125000,261000,136000,15.99,108.8,25,11.99
"1169",1169,"LEGO MARVEL's Avengers",217000,260000,43000,19.99,19.82,75,4.99
"1170",1170,"Anachronox",193000,260000,67000,6.99,34.72,86,0.97
"1171",1171,"The Jackbox Party Pack",248000,260000,12000,24.99,4.84,60,9.99
"1172",1172,"Oddworld: Munch's Oddysee",240000,259000,19000,4.99,7.92,75,1.24
"1173",1173,"Farming Simulator 19",0,259000,259000,34.99,0,0,34.99
"1174",1174,"Broken Sword 5 - the Serpent's Curse",217000,259000,42000,24.99,19.35,60,9.99
"1175",1175,"Alien Rage - Unlimited",238000,258000,20000,19.99,8.4,90,1.99
"1176",1176,"Insincere",167000,258000,91000,3.99,54.49,87,0.51
"1177",1177,"X2: The Threat",231000,257000,26000,4.99,11.26,50,2.49
"1178",1178,"Valley",137000,257000,120000,19.99,87.59,90,1.99
"1179",1179,"Evil Genius",241000,257000,16000,9.99,6.64,75,2.49
"1180",1180,"Danganronpa: Trigger Happy Havoc",207000,256000,49000,19.99,23.67,60,7.99
"1181",1181,"Sword With Sauce",171000,256000,85000,2.99,49.71,0,2.99
"1182",1182,"Planes, Bullets and Vodka",104000,256000,152000,0.99,146.15,90,0.49
"1183",1183,"Blackguards 2",176000,256000,80000,14.99,45.45,90,1.99
"1184",1184,"Comedy Night",250000,255000,5000,4.99,2,40,2.99
"1185",1185,"Cubetractor",253000,255000,2000,9.99,0.79,0,9.99
"1186",1186,"Xenonauts",238000,255000,17000,24.99,7.14,75,6.24
"1187",1187,"Revenge of the Titans",221000,255000,34000,14.99,15.38,63,5.54
"1188",1188,"Laraan",249000,254000,5000,4.99,2.01,50,2.49
"1189",1189,"La-Mulana",232000,254000,22000,14.99,9.48,67,4.94
"1190",1190,"Galaxy on Fire 2 Full HD",247000,254000,7000,7.99,2.83,63,2.95
"1191",1191,"Hard West",207000,254000,47000,19.99,22.71,90,1.99
"1192",1192,"Wishmaster",245000,254000,9000,0.99,3.67,51,0.49
"1193",1193,"Fahrenheit: Indigo Prophecy Remastered",207000,254000,47000,9.99,22.71,80,1.99
"1194",1194,"Freedom Force",192000,254000,62000,4.99,32.29,75,1.24
"1195",1195,"Cosmic Pioneer",77000,254000,177000,0.99,229.87,51,0.49
"1196",1196,"Gas Guzzlers Extreme",236000,253000,17000,24.99,7.2,82,4.49
"1197",1197,"PC Building Simulator",117000,253000,136000,19.99,116.24,25,14.99
"1198",1198,"Lumino City",184000,253000,69000,14.99,37.5,75,3.74
"1199",1199,"UNO",160000,252000,92000,9.99,57.5,66,3.39
"1200",1200,"Road Redemption",167000,252000,85000,19.99,50.9,50,9.99
"1201",1201,"3SwitcheD",135000,252000,117000,9.99,86.67,90,0.99
"1202",1202,"Ravenfield",162000,252000,90000,14.99,55.56,25,11.24
"1203",1203,"StarMade",218000,252000,34000,14.99,15.6,54,6.89
"1204",1204,"Data Hacker: Corruption",218000,252000,34000,2.99,15.6,83,0.5
"1205",1205,"Marble Mayhem: Fragile Ball",225000,251000,26000,1.99,11.56,75,0.49
"1206",1206,"Refunct",231000,251000,20000,2.99,8.66,67,0.98
"1207",1207,"Precipice of Darkness, Episode Two",238000,251000,13000,7.99,5.46,0,7.99
"1208",1208,"Shift 2 Unleashed",236000,251000,15000,19.99,6.36,75,4.99
"1209",1209,"Hard Room",243000,251000,8000,2.99,3.29,83,0.5
"1210",1210,"Weird Worlds: Return to Infinite Space",205000,251000,46000,4.99,22.44,80,0.99
"1211",1211,"Shake Your Money Simulator 2016",247000,250000,3000,0.99,1.21,51,0.49
"1212",1212,"GOD EATER 2 Rage Burst",232000,250000,18000,49.99,7.76,75,12.49
"1213",1213,"Pit People",227000,250000,23000,19.99,10.13,40,11.99
"1214",1214,"SEGA Bass Fishing",246000,250000,4000,7.99,1.63,85,1.19
"1215",1215,"Chompy Chomp Chomp",241000,250000,9000,1.99,3.73,50,0.99
"1216",1216,"DarkEnd",206000,250000,44000,1.99,21.36,90,0.79
"1217",1217,"White Mirror",222000,249000,27000,1.99,12.16,75,0.49
"1218",1218,"Sonic the Hedgehog 4 - Episode I",246000,249000,3000,9.99,1.22,75,2.49
"1219",1219,"POLYWAR",181000,248000,67000,4.99,37.02,90,0.49
"1220",1220,"AaaaaAAaaaAAAaaAAAAaAAAAA!!! for the Awesome",245000,248000,3000,9.99,1.22,78,2.19
"1221",1221,"RACE - The WTCC Game",245000,248000,3000,39.99,1.22,50,19.99
"1222",1222,"Painkiller Overdose",244000,247000,3000,4.99,1.23,75,1.24
"1223",1223,"The Room Two",229000,247000,18000,4.99,7.86,75,1.24
"1224",1224,"The Journey Down: Chapter One",176000,247000,71000,8.99,40.34,70,2.69
"1225",1225,"EVERSPACE",186000,247000,61000,29.99,32.8,70,8.99
"1226",1226,"Blades of Time",233000,246000,13000,9.99,5.58,0,9.99
"1227",1227,"Jagged Alliance - Back in Action",203000,246000,43000,19.99,21.18,80,3.99
"1228",1228,"Abandoned Knight",228000,246000,18000,2.99,7.89,83,0.5
"1229",1229,"Colin McRae Rally",237000,246000,9000,6.99,3.8,80,1.39
"1230",1230,"TowerFall Ascension",197000,246000,49000,14.99,24.87,50,7.49
"1231",1231,"Sonic the Hedgehog 4 - Episode II",164000,246000,82000,9.99,50,75,2.49
"1232",1232,"Sonic & SEGA All-Stars Racing",208000,246000,38000,9.99,18.27,75,2.49
"1233",1233,"Dead Pixels",228000,245000,17000,2.99,7.46,75,0.74
"1234",1234,"Splice",241000,245000,4000,9.99,1.66,0,9.99
"1235",1235,"Dead Age",204000,245000,41000,14.99,20.1,70,4.49
"1236",1236,"Space Hulk: Deathwing",215000,245000,30000,39.99,13.95,66,13.59
"1237",1237,"Divekick",236000,244000,8000,4.99,3.39,0,4.99
"1238",1238,"My Bones",179000,244000,65000,1.99,36.31,75,0.49
"1239",1239,"Whispering Willows",152000,244000,92000,9.99,60.53,80,1.99
"1240",1240,"Introvert Quest",195000,244000,49000,4.99,25.13,90,0.49
"1241",1241,"HardCube",214000,244000,30000,1.99,14.02,75,0.49
"1242",1242,"Paint the Town Red",204000,244000,40000,14.99,19.61,35,9.74
"1243",1243,"Super Star",188000,244000,56000,1.99,29.79,75,0.49
"1244",1244,"Blood Bowl 2",225000,244000,19000,19.99,8.44,70,5.99
"1245",1245,"Pillars of Eternity II: Deadfire",139000,244000,105000,49.99,75.54,34,32.99
"1246",1246,"Eldritch",205000,244000,39000,14.99,19.02,90,1.49
"1247",1247,"Devil May Cry 3 Special Edition",232000,243000,11000,19.99,4.74,75,4.99
"1248",1248,"Tom Clancy's Splinter Cell Double Agent",234000,243000,9000,9.99,3.85,66,3.39
"1249",1249,"Alien Run",215000,243000,28000,1.99,13.02,75,0.49
"1250",1250,"Rampage Knights",234000,243000,9000,11.99,3.85,75,2.99
"1251",1251,"Bionic Commando",234000,243000,9000,9.99,3.85,80,1.99
"1252",1252,"Nex Machina",195000,242000,47000,19.99,24.1,70,5.99
"1253",1253,"Rayman Legends",202000,242000,40000,29.99,19.8,66,10.19
"1254",1254,"Hyperdimension Neptunia Re;Birth2: Sisters Generation / 超次次元ゲイム ネプテューヌRe;Birth2 / 超次次元遊戲 戰機少女 重生2",199000,242000,43000,24.99,21.61,80,4.99
"1255",1255,"Rolling Sun",199000,242000,43000,4.99,21.61,90,0.49
"1256",1256,"Foxhole",199000,241000,42000,19.99,21.11,40,11.99
"1257",1257,"Spintires: MudRunner",183000,241000,58000,24.99,31.69,50,12.49
"1258",1258,"Freedom Force vs. the Third Reich",149000,241000,92000,4.99,61.74,75,1.24
"1259",1259,"CrossCode",89000,241000,152000,19.99,170.79,15,16.99
"1260",1260,"Insanely Twisted Shadow Planet",209000,241000,32000,14.99,15.31,75,3.74
"1261",1261,"Space Beret",229000,241000,12000,0.99,5.24,51,0.49
"1262",1262,"Trolley Gold",227000,241000,14000,1.99,6.17,50,0.99
"1263",1263,"BARRIER X",233000,240000,7000,2.99,3,75,0.74
"1264",1264,"Dead Island: Riptide Definitive Edition",180000,240000,60000,19.99,33.33,75,4.99
"1265",1265,"Run Away",238000,240000,2000,4.99,0.84,80,0.99
"1266",1266,"Samorost 3",168000,240000,72000,19.99,42.86,70,5.99
"1267",1267,"Worms",101000,239000,138000,7.99,136.63,80,1.59
"1268",1268,"Adventures of Shuggy",237000,239000,2000,4.99,0.84,90,0.49
"1269",1269,"King's Bounty: Warriors of the North",229000,239000,10000,9.99,4.37,80,1.99
"1270",1270,"Dragonia",178000,239000,61000,1.99,34.27,70,0.59
"1271",1271,"Need for Speed: Shift",224000,238000,14000,19.99,6.25,75,4.99
"1272",1272,"Super Duper Flying Genocide 2017",212000,238000,26000,0.99,12.26,51,0.49
"1273",1273,"Gone In November",182000,238000,56000,0.99,30.77,51,0.49
"1274",1274,"Aim Hero",2e+05,238000,38000,4.99,19,0,4.99
"1275",1275,"AI: Rampage",198000,238000,40000,1.99,20.2,75,0.49
"1276",1276,"I Am Alive",230000,237000,7000,14.99,3.04,75,3.74
"1277",1277,"Cruel Arena",120000,236000,116000,0.99,96.67,30,0.69
"1278",1278,"The Book of Unwritten Tales",226000,236000,10000,19.99,4.42,75,4.99
"1279",1279,"LEGO Star Wars III - The Clone Wars",212000,236000,24000,19.99,11.32,65,6.99
"1280",1280,"Gemini Rue",233000,236000,3000,9.99,1.29,75,2.49
"1281",1281,"Intergalactic Bubbles",216000,235000,19000,1.99,8.8,0,1.99
"1282",1282,"Vampyr",1e+05,235000,135000,49.99,135,50,24.99
"1283",1283,"High On Racing",202000,235000,33000,4.99,16.34,90,0.49
"1284",1284,"Mars: War Logs",224000,234000,10000,14.99,4.46,75,3.74
"1285",1285,"Watch This!",38000,234000,196000,3.99,515.79,87,0.51
"1286",1286,"Life Beetle",123000,234000,111000,0.99,90.24,51,0.49
"1287",1287,"The Heiress",143000,234000,91000,3.99,63.64,70,1.19
"1288",1288,"Numba Deluxe",215000,234000,19000,2.99,8.84,66,1.01
"1289",1289,"The Pit And The Pendulum",204000,234000,30000,3.99,14.71,87,0.51
"1290",1290,"STAR WARS: TIE Fighter Special Edition",212000,234000,22000,9.99,10.38,65,3.49
"1291",1291,"Bloop",172000,234000,62000,4.99,36.05,85,0.74
"1292",1292,"Anno 2205",166000,234000,68000,39.99,40.96,75,9.99
"1293",1293,"Invisible Mind",208000,234000,26000,4.99,12.5,90,0.49
"1294",1294,"OneShot",175000,233000,58000,9.99,33.14,40,5.99
"1295",1295,"Home Behind",204000,233000,29000,5.99,14.22,50,2.99
"1296",1296,"The Undying Plague",199000,233000,34000,0.99,17.09,0,0.99
"1297",1297,"Monster Loves You!",228000,233000,5000,9.99,2.19,50,4.99
"1298",1298,"Hyposphere",198000,233000,35000,2.99,17.68,70,0.89
"1299",1299,"Dungeons",211000,233000,22000,9.99,10.43,80,1.99
"1300",1300,"Speed Kills",189000,232000,43000,9.99,22.75,90,0.99
"1301",1301,"Project RPG Remastered",216000,232000,16000,0.99,7.41,51,0.49
"1302",1302,"16bit Trader",218000,232000,14000,2.99,6.42,83,0.5
"1303",1303,"The Butterfly Sign",201000,232000,31000,4.99,15.42,65,1.74
"1304",1304,"hack_me 2",199000,232000,33000,3.99,16.58,87,0.51
"1305",1305,"Z.I.O.N.",211000,232000,21000,4.99,9.95,90,0.49
"1306",1306,"HeXen: Beyond Heretic",184000,231000,47000,4.99,25.54,75,1.24
"1307",1307,"Battlepaths",213000,231000,18000,3.99,8.45,90,0.49
"1308",1308,"Seasons after Fall",207000,231000,24000,14.99,11.59,75,3.74
"1309",1309,"Bootombaa",190000,231000,41000,0.99,21.58,51,0.49
"1310",1310,"Megabyte Punch",219000,231000,12000,14.99,5.48,85,2.24
"1311",1311,"Machine Made: Rebirth",146000,231000,85000,4.99,58.22,70,1.49
"1312",1312,"Please, Don’t Touch Anything",210000,231000,21000,6.99,10,70,1.74
"1313",1313,"BlazBlue: Calamity Trigger",167000,231000,64000,9.99,38.32,85,1.49
"1314",1314,"SkyDrift",226000,231000,5000,9.99,2.21,75,2.49
"1315",1315,"Rayman Origins",220000,230000,10000,19.99,4.55,66,6.79
"1316",1316,"Scribblenauts Unmasked: A DC Comics Adventure",219000,230000,11000,19.99,5.02,75,4.99
"1317",1317,"Experience",166000,230000,64000,1.99,38.55,75,0.49
"1318",1318,"Startup Company",122000,230000,108000,9.99,88.52,40,5.99
"1319",1319,"Dear RED - Extended",205000,230000,25000,2.99,12.2,60,1.19
"1320",1320,"Pavlov VR",111000,230000,119000,9.99,107.21,40,5.99
"1321",1321,"Commander Keen",207000,229000,22000,4.99,10.63,75,1.24
"1322",1322,"Gun Rocket",197000,229000,32000,1.99,16.24,75,0.49
"1323",1323,"Sins Of The Demon RPG",214000,229000,15000,1.99,7.01,75,0.49
"1324",1324,"Majesty 2 Collection",190000,229000,39000,19.99,20.53,75,4.99
"1325",1325,"Darconika: The Cube of Soul",157000,229000,72000,3.99,45.86,87,0.51
"1326",1326,"Numberline",220000,229000,9000,1.99,4.09,75,0.49
"1327",1327,"Alien Shooter 2: Reloaded",215000,229000,14000,4.99,6.51,65,1.74
"1328",1328,"The Dark Stone from Mebara",168000,228000,60000,7.99,35.71,90,0.79
"1329",1329,"Unexpected Day",196000,228000,32000,0.99,16.33,51,0.49
"1330",1330,"Humanity Asset",205000,227000,22000,1.99,10.73,50,0.99
"1331",1331,"Sakura Beach",181000,227000,46000,9.99,25.41,75,2.49
"1332",1332,"Homeworld: Deserts of Kharak",204000,227000,23000,49.99,11.27,75,12.49
"1333",1333,"MASSIVE CHALICE",133000,227000,94000,19.99,70.68,80,3.99
"1334",1334,"Between Me and The Night",215000,227000,12000,14.99,5.58,75,3.74
"1335",1335,"2064: Read Only Memories",215000,227000,12000,19.99,5.58,85,2.99
"1336",1336,"Masked Shooters 2",216000,226000,10000,0.99,4.63,51,0.49
"1337",1337,"DARK SOULS: REMASTERED",222000,226000,4000,39.99,1.8,0,39.99
"1338",1338,"SUPER DISTRO",2e+05,226000,26000,0.99,13,51,0.49
"1339",1339,"Prince of Persia: The Two Thrones",172000,226000,54000,9.99,31.4,66,3.39
"1340",1340,"Deponia: The Complete Journey",214000,226000,12000,29.99,5.61,85,4.49
"1341",1341,"Cubium Dreams",198000,225000,27000,3.99,13.64,87,0.51
"1342",1342,"Maize",207000,225000,18000,19.99,8.7,75,4.99
"1343",1343,"Savant - Ascent",210000,225000,15000,1.99,7.14,75,0.49
"1344",1344,"Deponia Doomsday",204000,225000,21000,19.99,10.29,70,5.99
"1345",1345,"HeXen II",205000,225000,20000,4.99,9.76,75,1.24
"1346",1346,"Pathfinder: Kingmaker",0,225000,225000,39.99,0,20,31.99
"1347",1347,"InfiniPicross",192000,225000,33000,1.99,17.19,25,1.49
"1348",1348,"Deep Dungeons of Doom",212000,224000,12000,4.99,5.66,85,0.74
"1349",1349,"Carrier Command: Gaea Mission",213000,224000,11000,32.99,5.16,80,6.59
"1350",1350,"Project CARS 2",175000,224000,49000,59.99,28,67,19.79
"1351",1351,"Black Sand Drift",192000,224000,32000,0.99,16.67,51,0.49
"1352",1352,"The Spirit Underneath",156000,223000,67000,0.99,42.95,51,0.49
"1353",1353,"Call of Juarez: Bound in Blood",219000,223000,4000,9.99,1.83,75,2.49
"1354",1354,"Organ Biker",171000,223000,52000,0.99,30.41,0,0.99
"1355",1355,"Enemy Mind",216000,223000,7000,9.99,3.24,80,1.99
"1356",1356,"Project Pulsation",215000,223000,8000,4.99,3.72,90,0.49
"1357",1357,"Legend of Dungeon",217000,223000,6000,9.99,2.76,70,2.99
"1358",1358,"Danganronpa 2: Goodbye Despair",197000,222000,25000,19.99,12.69,60,7.99
"1359",1359,"Sakura Fantasy",211000,222000,11000,9.99,5.21,70,2.99
"1360",1360,"The Butterfly Sign: Human Error",189000,222000,33000,4.99,17.46,65,1.74
"1361",1361,"Renowned Explorers: International Society",210000,222000,12000,19.99,5.71,80,3.99
"1362",1362,"Neighbours from Hell Compilation",216000,222000,6000,9.99,2.78,75,2.49
"1363",1363,"Half Dead",215000,221000,6000,1.99,2.79,33,1.33
"1364",1364,"Daily Chthonicle: Editor's Edition",181000,221000,40000,3.99,22.1,40,2.39
"1365",1365,"Painkiller Redemption",188000,221000,33000,4.99,17.55,75,1.24
"1366",1366,"Merger 3D",219000,221000,2000,2.99,0.91,70,0.89
"1367",1367,"Toy Soldiers",218000,221000,3000,9.99,1.38,75,2.49
"1368",1368,"Blackbay Asylum",206000,221000,15000,19.99,7.28,90,1.99
"1369",1369,"ASSASSINATION BOX",154000,221000,67000,5.99,43.51,90,0.59
"1370",1370,"Chip",216000,221000,5000,4.99,2.31,70,1.49
"1371",1371,"Heat Signature",149000,221000,72000,14.99,48.32,50,7.49
"1372",1372,"The Next Door",215000,220000,5000,0.99,2.33,0,0.99
"1373",1373,"Horizon Shift",179000,220000,41000,4.99,22.91,80,0.99
"1374",1374,"Slavistan",109000,220000,111000,1.99,101.83,75,0.49
"1375",1375,"Splatter - Zombie Apocalypse",194000,220000,26000,0.99,13.4,51,0.49
"1376",1376,"INK",210000,220000,10000,4.99,4.76,0,4.99
"1377",1377,"Frankenstein: Master of Death",185000,219000,34000,4.99,18.38,75,1.24
"1378",1378,"Gold Rush: The Game",151000,219000,68000,19.99,45.03,50,9.99
"1379",1379,"The Housewife",210000,219000,9000,4.99,4.29,50,2.49
"1380",1380,"Neon Chrome",205000,219000,14000,14.99,6.83,75,3.74
"1381",1381,"Jade Empire: Special Edition",213000,218000,5000,14.99,2.35,75,3.74
"1382",1382,"Pool Nation",211000,218000,7000,6.99,3.32,70,2.09
"1383",1383,"Phantom Soldier",18000,218000,2e+05,0.99,1111.11,51,0.49
"1384",1384,"Among the Sleep - Enhanced Edition",209000,218000,9000,16.99,4.31,60,6.79
"1385",1385,"RPG Maker MV",186000,218000,32000,79.99,17.2,75,19.99
"1386",1386,"Heretic: Shadow of the Serpent Riders",191000,218000,27000,4.99,14.14,75,1.24
"1387",1387,"Deadly Premonition: The Director's Cut",187000,218000,31000,24.99,16.58,90,2.49
"1388",1388,"Iesabel",211000,217000,6000,4.99,2.84,90,0.49
"1389",1389,"Blood Omen 2: Legacy of Kain",2e+05,217000,17000,6.99,8.5,86,0.97
"1390",1390,"Super LOH",189000,217000,28000,0.99,14.81,51,0.49
"1391",1391,"Western FPS",176000,217000,41000,0.99,23.3,51,0.49
"1392",1392,"The Fall",203000,216000,13000,9.99,6.4,80,1.99
"1393",1393,"Uriel's Chasm 2: את",162000,216000,54000,4.99,33.33,85,0.74
"1394",1394,"PARTICLE MACE",212000,216000,4000,9.99,1.89,90,0.99
"1395",1395,"Sniper Art of Victory",189000,216000,27000,2.99,14.29,80,0.59
"1396",1396,"BoneBone: Rise of the Deathlord",180000,215000,35000,1.99,19.44,0,1.99
"1397",1397,"Castlevania: Lords of Shadow 2",208000,215000,7000,39.99,3.37,80,7.99
"1398",1398,"X: Beyond the Frontier",213000,215000,2000,4.99,0.94,50,2.49
"1399",1399,"The Lords of the Earth Flame",209000,215000,6000,9.99,2.87,80,1.99
"1400",1400,"Vanquish",173000,215000,42000,19.99,24.28,66,6.79
"1401",1401,"Itineris",209000,215000,6000,0.99,2.87,51,0.49
"1402",1402,"Avadon: The Black Fortress",181000,215000,34000,9.99,18.78,70,2.99
"1403",1403,"Port Royale 3",204000,214000,10000,14.99,4.9,80,2.99
"1404",1404,"Rabiez: Epidemic",184000,214000,30000,1.99,16.3,75,0.49
"1405",1405,"Puyo PuyoTetris",34000,214000,180000,19.99,529.41,33,13.39
"1406",1406,"STAR WARS Rebellion",194000,214000,20000,5.99,10.31,66,2.03
"1407",1407,"Mind Spheres",199000,214000,15000,0.99,7.54,51,0.49
"1408",1408,"PixelJunk Monsters Ultimate",207000,214000,7000,9.99,3.38,85,1.49
"1409",1409,"ROMANCE OF THE THREE KINGDOMS XIII / 三國志13",204000,214000,10000,59.99,4.9,60,23.99
"1410",1410,"A Valley Without Wind",211000,214000,3000,14.99,1.42,80,2.99
"1411",1411,"fault - milestone one",202000,214000,12000,14.99,5.94,66,5.09
"1412",1412,"Castle Story",210000,213000,3000,24.99,1.43,40,14.99
"1413",1413,"Tales of Maj'Eyal",184000,213000,29000,6.99,15.76,50,3.49
"1414",1414,"Hektor",142000,213000,71000,9.99,50,90,0.99
"1415",1415,"Of Orcs And Men",181000,212000,31000,14.99,17.13,85,2.24
"1416",1416,"Bound By Flame",208000,212000,4000,19.99,1.92,80,3.99
"1417",1417,"Gothic 3: Forsaken Gods Enhanced Edition",205000,212000,7000,9.99,3.41,75,2.49
"1418",1418,"GALAK-Z",150000,212000,62000,19.99,41.33,75,4.99
"1419",1419,"What's under your blanket !?",190000,212000,22000,0.99,11.58,35,0.64
"1420",1420,"Space Pilgrim Episode II: Epsilon Indi",197000,211000,14000,1.99,7.11,75,0.49
"1421",1421,"Penny Arcade's On the Rain-Slick Precipice of Darkness 4",193000,211000,18000,1.99,9.33,70,0.59
"1422",1422,"Brigador: Up-Armored Edition",140000,211000,71000,19.99,50.71,30,13.99
"1423",1423,"The Pasture",106000,211000,105000,0.99,99.06,51,0.49
"1424",1424,"Defender's Quest: Valley of the Forgotten (DX edition)",199000,211000,12000,14.99,6.03,50,7.49
"1425",1425,"Highway Blossoms",152000,210000,58000,12.99,38.16,40,7.79
"1426",1426,"Apartment 666",190000,210000,20000,0.99,10.53,0,0.99
"1427",1427,"Spirits",208000,210000,2000,3.99,0.96,75,0.99
"1428",1428,"Railroad Tycoon II Platinum",139000,210000,71000,4.99,51.08,75,1.24
"1429",1429,"Red Risk",198000,210000,12000,0.99,6.06,51,0.49
"1430",1430,"Archery Practice VR",12000,210000,198000,0.99,1650,51,0.49
"1431",1431,"Guns of Icarus Alliance",152000,210000,58000,14.99,38.16,85,2.24
"1432",1432,"Master of Orion",198000,209000,11000,29.99,5.56,75,7.49
"1433",1433,"Pixel Puzzles 2: Birds",2e+05,209000,9000,9.99,4.5,85,1.49
"1434",1434,"Autumn Dream",156000,209000,53000,2.99,33.97,84,0.49
"1435",1435,"Kenshi",151000,209000,58000,29.99,38.41,20,15.99
"1436",1436,"BitMaster",199000,209000,10000,2.99,5.03,70,0.89
"1437",1437,"Daikatana",198000,209000,11000,6.99,5.56,86,0.97
"1438",1438,"Galactic Fighter",134000,208000,74000,0.99,55.22,51,0.49
"1439",1439,"The Atomy",157000,208000,51000,3.99,32.48,87,0.51
"1440",1440,"System Shock: Enhanced Edition",195000,208000,13000,9.99,6.67,80,1.99
"1441",1441,"Plantera",185000,207000,22000,2.99,11.89,80,0.59
"1442",1442,"Mad Games Tycoon",175000,207000,32000,14.99,18.29,50,7.49
"1443",1443,"Superflight",175000,207000,32000,2.99,18.29,75,0.74
"1444",1444,"STRAFE: Millennium Edition",174000,207000,33000,14.99,18.97,75,3.74
"1445",1445,"Prince of Persia: The Forgotten Sands",187000,207000,20000,9.99,10.7,66,3.39
"1446",1446,"Post Apocalyptic Mayhem",188000,207000,19000,9.99,10.11,60,3.99
"1447",1447,"SpellForce 3",137000,206000,69000,49.99,50.36,50,24.99
"1448",1448,"Cyberhunt",60000,206000,146000,0.99,243.33,90,0.49
"1449",1449,"Injustice 2",97000,206000,109000,49.99,112.37,50,24.99
"1450",1450,"Dishonored: Death of the Outsider",140000,206000,66000,29.99,47.14,50,14.99
"1451",1451,"24 HOURS",152000,206000,54000,0.99,35.53,83,0.49
"1452",1452,"Takedown: Red Sabre",2e+05,206000,6000,4.99,3,0,4.99
"1453",1453,"Hot Dogs, Horseshoes & Hand Grenades",105000,206000,101000,19.99,96.19,0,19.99
"1454",1454,"Professional Farmer 2014",181000,206000,25000,14.99,13.81,75,4.99
"1455",1455,"Depth Hunter 2: Deep Dive",203000,206000,3000,14.99,1.48,75,3.74
"1456",1456,"Rocksmith",139000,205000,66000,29.99,47.48,70,8.99
"1457",1457,"Trials Fusion",193000,205000,12000,19.99,6.22,70,5.99
"1458",1458,"Space Trader: Merchant Marine",202000,205000,3000,4.99,1.49,80,0.99
"1459",1459,"Flatout 3: Chaos & Destruction",175000,205000,30000,9.99,17.14,90,0.99
"1460",1460,"ZRoll",203000,205000,2000,0.99,0.99,33,0.66
"1461",1461,"Survivalist",193000,205000,12000,4.99,6.22,70,1.49
"1462",1462,"PixBit",167000,204000,37000,1.99,22.16,75,0.49
"1463",1463,"Crispy Chicken",150000,204000,54000,4.99,36,90,0.49
"1464",1464,"Job Simulator",174000,203000,29000,19.99,16.67,25,14.99
"1465",1465,"Infinifactory",165000,203000,38000,24.99,23.03,75,6.24
"1466",1466,"I, Zombie",189000,202000,13000,1.99,6.88,75,0.49
"1467",1467,"One way to exit",153000,202000,49000,1.99,32.03,70,0.59
"1468",1468,"Hiiro",196000,202000,6000,2.99,3.06,33,2
"1469",1469,"Farnham Fables",198000,202000,4000,0.99,2.02,51,0.49
"1470",1470,"Train Fever",186000,201000,15000,19.99,8.06,85,2.99
"1471",1471,"X: Tension",49000,201000,152000,4.99,310.2,50,2.49
"1472",1472,"Hyperdimension Neptunia Re;Birth3 V Generation / 神次次元ゲイム ネプテューヌRe;Birth3 V CENTURY / 神次次元遊戲 戰機少女 重生3 Ｖ世紀",181000,201000,20000,24.99,11.05,80,4.99
"1473",1473,"Mighty No. 9",175000,201000,26000,19.99,14.86,80,3.99
"1474",1474,"Two Digits",156000,2e+05,44000,1.99,28.21,75,0.49
"1475",1475,"Order of War",191000,2e+05,9000,7.99,4.71,85,1.19
"1476",1476,"STAR WARS: Rogue Squadron 3D",173000,2e+05,27000,9.99,15.61,65,3.49
"1477",1477,"QuestRun",196000,2e+05,4000,4.99,2.04,80,0.99
"1478",1478,"FINAL FANTASY III",183000,2e+05,17000,15.99,9.29,50,7.99
"1479",1479,"Hospital Tycoon",187000,2e+05,13000,4.99,6.95,75,1.24
"1480",1480,"12 Labours of Hercules II: The Cretan Bull",178000,199000,21000,2.99,11.8,83,0.5
"1481",1481,"Gremlins, Inc.",146000,199000,53000,14.99,36.3,75,3.74
"1482",1482,"140",193000,199000,6000,4.99,3.11,80,0.99
"1483",1483,"Flagster",103000,199000,96000,0.99,93.2,51,0.49
"1484",1484,"Heckabomb",159000,199000,40000,5.99,25.16,90,0.59
"1485",1485,"HeXen: Deathkings of the Dark Citadel",66000,199000,133000,4.99,201.52,75,1.24
"1486",1486,"Umbrella Corps/Biohazard Umbrella Corps",183000,198000,15000,19.99,8.2,80,4.39
"1487",1487,"Shantae: Risky's Revenge - Director's Cut",196000,198000,2000,9.99,1.02,50,4.99
"1488",1488,"Tilt Brush",195000,198000,3000,19.99,1.54,50,9.99
"1489",1489,"Space Run",186000,198000,12000,14.99,6.45,75,3.74
"1490",1490,"28 Waves Later",147000,198000,51000,4.99,34.69,90,0.49
"1491",1491,"Hexcells",190000,198000,8000,2.99,4.21,70,0.89
"1492",1492,"Steel Division: Normandy 44",154000,198000,44000,39.99,28.57,66,13.59
"1493",1493,"Okhlos: Omega",144000,198000,54000,12.99,37.5,75,3.24
"1494",1494,"Enemy Front",182000,198000,16000,19.99,8.79,90,1.99
"1495",1495,"Red Faction Guerrilla Re-Mars-tered",0,197000,197000,19.99,0,67,6.59
"1496",1496,"Batman: The Enemy Within - The Telltale Series",112000,197000,85000,14.99,75.89,60,9.99
"1497",1497,"Tap Heroes",173000,197000,24000,2.99,13.87,80,0.59
"1498",1498,"Demigod",147000,197000,50000,9.99,34.01,50,4.99
"1499",1499,"Anomaly Korea",187000,197000,10000,4.99,5.35,85,0.74
"1500",1500,"Carmageddon: Max Damage",146000,197000,51000,16.99,34.93,75,4.24
"1501",1501,"Platro",132000,197000,65000,0.99,49.24,51,0.49
"1502",1502,"The Return Home Remastered",160000,197000,37000,0.99,23.13,51,0.49
"1503",1503,"Minimized",166000,196000,30000,3.99,18.07,87,0.51
"1504",1504,"Bomber Crew",158000,196000,38000,14.99,24.05,50,7.49
"1505",1505,"BlazBlue: Chronophantasma Extend",181000,196000,15000,29.99,8.29,85,4.49
"1506",1506,"Rock 'N' Roll Defense",81000,195000,114000,0.99,140.74,90,0.49
"1507",1507,"Physic Monster",157000,195000,38000,1.99,24.2,75,0.49
"1508",1508,"Agarest: Generations of War",164000,195000,31000,14.99,18.9,75,3.74
"1509",1509,"Obulis",191000,195000,4000,4.99,2.09,80,0.99
"1510",1510,"Sometimes: Success Requires Sacrifice",182000,195000,13000,0.99,7.14,51,0.49
"1511",1511,"Darkwood",150000,195000,45000,14.99,30,50,7.49
"1512",1512,"Volume",190000,195000,5000,19.99,2.63,75,4.99
"1513",1513,"Epic Battle Fantasy 4",159000,195000,36000,11.99,22.64,75,2.99
"1514",1514,"Electronic Super Joy",189000,194000,5000,7.99,2.65,90,0.79
"1515",1515,"STAR WARS - X-Wing Special Edition",177000,194000,17000,9.99,9.6,65,3.49
"1516",1516,"Lost Planet 2",181000,194000,13000,19.99,7.18,80,3.99
"1517",1517,"Mafia",153000,193000,40000,14.99,26.14,33,10.04
"1518",1518,"Apotheon",173000,193000,20000,14.99,11.56,75,3.74
"1519",1519,"F1 2014",149000,193000,44000,29.99,29.53,75,7.49
"1520",1520,"Night in the Woods",161000,192000,31000,19.99,19.25,40,11.99
"1521",1521,"Spaceport Hope",117000,192000,75000,1.99,64.1,75,0.49
"1522",1522,"Universe in Fire",169000,192000,23000,1.99,13.61,75,0.49
"1523",1523,"The Last Hope: Trump vs Mafia - North Korea",176000,192000,16000,1.99,9.09,90,0.49
"1524",1524,"Lugaru HD",144000,191000,47000,9.99,32.64,80,1.99
"1525",1525,"Nikopol: Secrets of the Immortals",188000,191000,3000,4.99,1.6,80,0.99
"1526",1526,"Pixel Puzzles 2: Space",175000,191000,16000,9.99,9.14,85,1.49
"1527",1527,"Thirty Flights of Loving",182000,191000,9000,4.99,4.95,66,1.69
"1528",1528,"Painkiller: Resurrection",179000,191000,12000,9.99,6.7,75,2.49
"1529",1529,"Sinister City",178000,190000,12000,0.99,6.74,51,0.49
"1530",1530,"Jack's Gang",148000,190000,42000,1.99,28.38,75,0.49
"1531",1531,"WASTED",138000,190000,52000,12.99,37.68,90,1.29
"1532",1532,"Jack Orlando: Director's Cut",149000,190000,41000,4.99,27.52,80,0.99
"1533",1533,"NECROPOLIS: BRUTAL EDITION",160000,190000,30000,29.99,18.75,84,4.79
"1534",1534,"Islands of Nyne: Battle Royale",0,190000,190000,9.99,0,60,9.99
"1535",1535,"Ridge Racer Unbounded",184000,190000,6000,9.99,3.26,75,2.49
"1536",1536,"Incoming Forces",184000,190000,6000,2.99,3.26,70,0.89
"1537",1537,"The Adventurer - Episode 1: Beginning of the End",122000,190000,68000,0.99,55.74,75,0.49
"1538",1538,"Mushroom 11",151000,189000,38000,14.99,25.17,0,14.99
"1539",1539,"Outrunner",152000,189000,37000,0.99,24.34,51,0.49
"1540",1540,"Bunker 58",164000,189000,25000,1.99,15.24,0,1.99
"1541",1541,"SpellForce - Platinum Edition",185000,189000,4000,9.99,2.16,80,1.99
"1542",1542,"911 Operator",147000,189000,42000,14.99,28.57,60,5.99
"1543",1543,"Valdis Story: Abyssal City",182000,189000,7000,14.99,3.85,65,5.24
"1544",1544,"Darkest Hour: A Hearts of Iron Game",173000,189000,16000,9.99,9.25,80,1.99
"1545",1545,"GoNNER",173000,188000,15000,9.99,8.67,80,1.99
"1546",1546,"Strike Suit Infinity",180000,188000,8000,6.99,4.44,80,1.39
"1547",1547,"HIVESWAP: Act 1",142000,188000,46000,7.99,32.39,50,3.99
"1548",1548,"Running Sausage",168000,188000,20000,0.99,11.9,51,0.49
"1549",1549,"TrackMania² Canyon",182000,188000,6000,19.99,3.3,70,5.99
"1550",1550,"METAL SLUG",174000,188000,14000,7.99,8.05,50,3.99
"1551",1551,"Dream Pinball 3D",173000,187000,14000,6.99,8.09,86,0.97
"1552",1552,"Horror Hospital",151000,187000,36000,0.99,23.84,51,0.49
"1553",1553,"Finding Paradise",152000,187000,35000,9.99,23.03,40,5.99
"1554",1554,"Spacebase DF-9",154000,187000,33000,9.99,21.43,85,1.49
"1555",1555,"West of Loathing",145000,187000,42000,10.99,28.97,33,7.36
"1556",1556,">observer_",62000,187000,125000,29.99,201.61,55,13.49
"1557",1557,"Patrician IV - Steam Special Edition",153000,186000,33000,14.99,21.57,80,2.99
"1558",1558,"A Valley Without Wind 2",133000,186000,53000,14.99,39.85,80,2.99
"1559",1559,"Singularity",173000,186000,13000,29.99,7.51,75,7.49
"1560",1560,"Men of War: Vietnam",167000,186000,19000,7.99,11.38,75,1.99
"1561",1561,"The Final Station",168000,186000,18000,14.99,10.71,67,4.94
"1562",1562,"Super Sanctum TD",180000,185000,5000,4.99,2.78,80,0.99
"1563",1563,"Zup!",171000,185000,14000,0.99,8.19,30,0.69
"1564",1564,"Thimbleweed Park",172000,184000,12000,19.99,6.98,40,11.99
"1565",1565,"Mitsurugi Kamui Hikae",178000,184000,6000,9.99,3.37,67,3.29
"1566",1566,"DeadCore",181000,184000,3000,9.99,1.66,75,2.49
"1567",1567,"Hook",173000,184000,11000,0.99,6.36,25,0.74
"1568",1568,"Towns",175000,184000,9000,14.99,5.14,70,4.49
"1569",1569,"F1 2017",160000,183000,23000,59.99,14.38,75,14.99
"1570",1570,"PixARK",167000,183000,16000,24.99,9.58,25,18.74
"1571",1571,"Anodyne",181000,183000,2000,9.99,1.1,70,2.99
"1572",1572,"Citizens of Earth",174000,183000,9000,14.99,5.17,80,2.99
"1573",1573,"Ys I & II Chronicles+",158000,183000,25000,14.99,15.82,70,4.49
"1574",1574,"Holy Potatoes! A Weapon Shop?!",179000,182000,3000,14.99,1.68,80,2.99
"1575",1575,"Timore Inferno",123000,182000,59000,4.99,47.97,35,3.24
"1576",1576,"Iron Brigade",164000,182000,18000,14.99,10.98,85,2.24
"1577",1577,"FINAL FANTASY IV",151000,182000,31000,15.99,20.53,50,7.99
"1578",1578,"ArcaniA: Fall of Setarrif",176000,182000,6000,14.99,3.41,75,3.74
"1579",1579,"//N.P.P.D. RUSH//- The milk of Ultraviolet",169000,182000,13000,3.99,7.69,85,0.59
"1580",1580,"Bloop Reloaded",172000,181000,9000,9.99,5.23,85,1.49
"1581",1581,"Ace Of Words",139000,181000,42000,4.99,30.22,0,4.99
"1582",1582,"Cursed Castilla (Maldita Castilla EX)",171000,181000,10000,11.99,5.85,50,5.99
"1583",1583,"Tidalis",150000,181000,31000,4.99,20.67,80,0.99
"1584",1584,"Sparkle 3 Genesis",155000,181000,26000,4.99,16.77,90,0.49
"1585",1585,"20XX",104000,181000,77000,14.99,74.04,50,7.49
"1586",1586,"Lost Moon",113000,180000,67000,1.99,59.29,20,1.59
"1587",1587,"1914: Prelude to Chaos",130000,180000,50000,0.99,38.46,51,0.49
"1588",1588,"Last Tale",160000,180000,20000,0.99,12.5,51,0.49
"1589",1589,"Distance",125000,180000,55000,24.99,44,35,13.39
"1590",1590,"BallisticNG",174000,179000,5000,7.99,2.87,0,4.99
"1591",1591,"Battleplan: American Civil War",175000,179000,4000,9.99,2.29,85,1.49
"1592",1592,"The Odyssey: Winds of Athena",163000,179000,16000,4.99,9.82,90,0.49
"1593",1593,"Journey of a Roach",163000,179000,16000,6.99,9.82,90,0.69
"1594",1594,"Rock of Ages 2: Bigger & Boulder",118000,179000,61000,14.99,51.69,66,5.09
"1595",1595,"ANIMALITY",165000,179000,14000,1.99,8.48,50,0.99
"1596",1596,"Cowboy zombie",172000,178000,6000,0.99,3.49,51,0.49
"1597",1597,"Time Of Silence",163000,178000,15000,0.99,9.2,51,0.49
"1598",1598,"BADLAND: Game of the Year Edition",155000,178000,23000,9.99,14.84,90,1.19
"1599",1599,"Soul Gambler",157000,178000,21000,4.99,13.38,90,0.49
"1600",1600,"FINAL FANTASY TYPE-0 HD",162000,178000,16000,29.99,9.88,50,14.99
"1601",1601,"Shoot Paint",174000,178000,4000,0.99,2.3,51,0.49
"1602",1602,"Secrets of Grindea",144000,178000,34000,14.99,23.61,0,14.99
"1603",1603,"NOT A HERO",123000,178000,55000,12.99,44.72,75,3.24
"1604",1604,"Draw a Stickman: EPIC",166000,178000,12000,3.99,7.23,50,1.99
"1605",1605,"Phantom Breaker: Battle Grounds",173000,178000,5000,11.99,2.89,60,4.79
"1606",1606,"The Mean Greens - Plastic Warfare",174000,178000,4000,9.99,2.3,80,1.99
"1607",1607,"TAIKU MANSION",135000,178000,43000,0.99,31.85,51,0.49
"1608",1608,"Rise to Ruins",78000,178000,1e+05,9.99,128.21,50,4.99
"1609",1609,"Finnish Roller",173000,177000,4000,0.99,2.31,51,0.49
"1610",1610,"Submerged",156000,177000,21000,19.99,13.46,90,1.99
"1611",1611,"Larva Mortus",171000,177000,6000,4.99,3.51,80,0.99
"1612",1612,"Event[0]",118000,177000,59000,19.99,50,50,9.99
"1613",1613,"Aircraft War X",153000,176000,23000,0.99,15.03,83,0.49
"1614",1614,"CastleStorm",172000,176000,4000,9.99,2.33,75,2.49
"1615",1615,"Icewind Dale: Enhanced Edition",161000,176000,15000,19.99,9.32,80,3.99
"1616",1616,"Overcooked! 2",0,176000,176000,24.99,0,25,18.74
"1617",1617,"Avorion",126000,175000,49000,17.99,38.89,30,12.59
"1618",1618,"DreadOut: Keepers of The Dark",122000,174000,52000,6.99,42.62,70,2.09
"1619",1619,"Might & Magic X - Legacy",168000,174000,6000,24.99,3.57,75,6.24
"1620",1620,"Not The Robots",153000,174000,21000,9.99,13.73,75,2.49
"1621",1621,"Full Spectrum Warrior: Ten Hammers",87000,174000,87000,9.99,100,75,2.49
"1622",1622,"Moccasin",171000,174000,3000,0.99,1.75,51,0.49
"1623",1623,"Paranautical Activity: Deluxe Atonement Edition",162000,174000,12000,9.99,7.41,90,0.99
"1624",1624,"The Surge",126000,173000,47000,29.99,37.3,66,11.99
"1625",1625,"Creeper World 3: Arc Eternal",157000,173000,16000,14.99,10.19,40,8.99
"1626",1626,"Sweet Lily Dreams",168000,173000,5000,14.99,2.98,80,2.99
"1627",1627,"Robotex",162000,173000,11000,4.99,6.79,90,0.49
"1628",1628,"The Isle",165000,173000,8000,19.99,4.85,33,13.39
"1629",1629,"Final Exam",157000,173000,16000,9.99,10.19,80,1.99
"1630",1630,"Glacier 3: The Meltdown",109000,172000,63000,2.99,57.8,70,0.89
"1631",1631,"The Dreamlord",161000,172000,11000,3.99,6.83,87,0.51
"1632",1632,"The Solus Project",105000,172000,67000,19.99,63.81,50,9.99
"1633",1633,"Disciples III - Renaissance Steam Special Edition",169000,172000,3000,14.99,1.78,85,2.24
"1634",1634,"Warhammer 40,000: Inquisitor - Martyr",108000,172000,64000,49.99,59.26,25,37.49
"1635",1635,"Tenrow",155000,172000,17000,2.99,10.97,83,0.5
"1636",1636,"StarDrive",170000,172000,2000,29.99,1.18,85,4.49
"1637",1637,"Another World – 20th Anniversary Edition",169000,171000,2000,9.99,1.18,75,2.49
"1638",1638,"The Guild Gold Edition",151000,171000,20000,9.99,13.25,75,2.49
"1639",1639,"Kung Fu Strike - The Warrior's Rise",169000,171000,2000,9.99,1.18,90,0.99
"1640",1640,"Freeman: Guerrilla Warfare",108000,171000,63000,14.99,58.33,20,11.99
"1641",1641,"The Void",102000,171000,69000,9.99,67.65,80,1.99
"1642",1642,"Hyper Fighters",126000,170000,44000,2.99,34.92,70,0.89
"1643",1643,"Robowars",166000,170000,4000,14.99,2.41,90,1.49
"1644",1644,"The Lost Souls",132000,170000,38000,1.99,28.79,75,0.49
"1645",1645,"ROCKETSROCKETSROCKETS",166000,170000,4000,6.99,2.41,50,3.49
"1646",1646,"Citalis",152000,170000,18000,1.99,11.84,65,0.69
"1647",1647,"Ys: The Oath in Felghana",143000,170000,27000,14.99,18.88,70,4.49
"1648",1648,"Terrorhedron Tower Defense",167000,170000,3000,1.99,1.8,75,0.49
"1649",1649,"Redemption: Eternal Quest",160000,170000,10000,1.99,6.25,60,0.79
"1650",1650,"Assassin’s Creed Liberation HD",166000,170000,4000,19.99,2.41,66,6.79
"1651",1651,"Space Rangers HD: A War Apart",161000,170000,9000,14.99,5.59,75,3.74
"1652",1652,"Dreamfall: The Longest Journey",158000,170000,12000,19.99,7.59,70,5.99
"1653",1653,"Strike Vector",151000,170000,19000,11.99,12.58,0,11.99
"1654",1654,"Nux",159000,170000,11000,6.99,6.92,90,0.69
"1655",1655,"Arizona Sunshine",122000,170000,48000,39.99,39.34,50,19.99
"1656",1656,"Yu-Gi-Oh! Legacy of the Duelist",128000,170000,42000,19.99,32.81,50,9.99
"1657",1657,"Broken Sword 3 - the Sleeping Dragon",154000,169000,15000,5.99,9.74,60,2.39
"1658",1658,"Amazing Frog?",68000,169000,101000,15.99,148.53,0,15.99
"1659",1659,"WWE 2K16",141000,169000,28000,49.99,19.86,0,49.99
"1660",1660,"Creature Clicker - Capture, Train, Ascend!",146000,169000,23000,1.99,15.75,50,0.99
"1661",1661,"Strong Bad's Cool Game for Attractive People: Season 1",164000,169000,5000,19.99,3.05,70,5.99
"1662",1662,"Arx Fatalis",126000,169000,43000,4.99,34.13,75,1.24
"1663",1663,"RollerCoaster Tycoon World",159000,169000,10000,14.99,6.29,0,14.99
"1664",1664,"So Many Cubes",148000,169000,21000,1.99,14.19,75,0.49
"1665",1665,"Hexcells Infinite",162000,169000,7000,4.99,4.32,70,1.49
"1666",1666,"Secrets of Rætikon",153000,169000,16000,9.99,10.46,66,3.39
"1667",1667,"Rebuild 3: Gangs of Deadsville",146000,168000,22000,14.99,15.07,50,7.49
"1668",1668,"Eon Altar",161000,168000,7000,4.99,4.35,66,1.69
"1669",1669,"Passpartout: The Starving Artist",158000,168000,10000,9.99,6.33,50,4.99
"1670",1670,"Fluffy Creatures VS The World",156000,168000,12000,0.99,7.69,51,0.49
"1671",1671,"Moon Hunters",146000,168000,22000,14.99,15.07,65,5.24
"1672",1672,"Double Dragon: Neon",142000,168000,26000,9.99,18.31,85,1.49
"1673",1673,"Omikron: The Nomad Soul",147000,168000,21000,9.99,14.29,85,1.49
"1674",1674,"The Sexy Brutale",148000,168000,20000,19.99,13.51,50,9.99
"1675",1675,"Legends of Eisenwald",121000,168000,47000,19.99,38.84,85,2.99
"1676",1676,"DG2: Defense Grid 2",153000,167000,14000,14.99,9.15,75,3.74
"1677",1677,"Hentai Girl",0,167000,167000,0.99,0,40,0.59
"1678",1678,"The Orb Chambers",111000,167000,56000,0.99,50.45,40,0.59
"1679",1679,"Out of the Park Baseball 18",121000,167000,46000,19.99,38.02,0,19.99
"1680",1680,"Survival: Postapocalypse Now",141000,167000,26000,4.99,18.44,50,2.49
"1681",1681,"Painkiller: Recurring Evil",164000,167000,3000,9.99,1.83,75,2.49
"1682",1682,"Crazy Forest",126000,166000,40000,4.99,31.75,90,0.49
"1683",1683,"Elems",150000,166000,16000,0.99,10.67,51,0.49
"1684",1684,"Night Forest",153000,166000,13000,1.99,8.5,75,0.49
"1685",1685,"Blitzkrieg 2 Anthology",142000,166000,24000,4.99,16.9,70,1.49
"1686",1686,"Kona",51000,166000,115000,14.99,225.49,50,7.49
"1687",1687,"Might & Magic Heroes VII",141000,166000,25000,29.99,17.73,75,7.49
"1688",1688,"Mega Man Legacy Collection / ロックマン クラシックス コレクション",115000,166000,51000,14.99,44.35,60,5.99
"1689",1689,"Torment: Tides of Numenera",140000,166000,26000,44.99,18.57,67,14.84
"1690",1690,"PHAT STACKS",132000,165000,33000,1.99,25,50,0.99
"1691",1691,"VERGE:Lost chapter",153000,165000,12000,1.99,7.84,75,0.49
"1692",1692,"Redout: Enhanced Edition",133000,165000,32000,34.99,24.06,75,8.74
"1693",1693,"Golfing Over It with Alva Majo",88000,165000,77000,4.99,87.5,20,3.99
"1694",1694,"If My Heart Had Wings",120000,165000,45000,14.99,37.5,75,3.74
"1695",1695,"GemCraft - Chasing Shadows",158000,165000,7000,9.99,4.43,75,2.49
"1696",1696,"Shadow Complex Remastered",160000,165000,5000,14.99,3.13,0,14.99
"1697",1697,"Celeste",71000,165000,94000,19.99,132.39,20,15.99
"1698",1698,"Heaven Forest NIGHTS",147000,164000,17000,0.99,11.56,0,0.99
"1699",1699,"Violett Remastered",149000,164000,15000,9.99,10.07,90,0.99
"1700",1700,"Secret in Story",63000,164000,101000,0.99,160.32,0,0.99
"1701",1701,"Hexcells Plus",162000,164000,2000,2.99,1.23,70,0.89
"1702",1702,"Escape: VR",161000,164000,3000,2.99,1.86,83,0.5
"1703",1703,"Approaching Blocks",119000,164000,45000,1.99,37.82,75,0.49
"1704",1704,"Battle Ranch: Pigs vs Plants",154000,164000,10000,1.99,6.49,75,0.49
"1705",1705,"DOKA 2",114000,164000,50000,3.99,43.86,88,0.49
"1706",1706,"Assassin’s Creed Chronicles: China",157000,164000,7000,9.99,4.46,66,3.39
"1707",1707,"Nash Racing",126000,164000,38000,3.99,30.16,88,0.49
"1708",1708,"DEAD RISING",115000,163000,48000,19.99,41.74,70,5.99
"1709",1709,"Alter World",150000,163000,13000,1.99,8.67,70,0.59
"1710",1710,"Axiom Verge",136000,163000,27000,19.99,19.85,50,9.99
"1711",1711,"Geometry Wars: Retro Evolved",161000,163000,2000,3.99,1.24,50,1.99
"1712",1712,"Urban Trial Freestyle",161000,163000,2000,6.99,1.24,80,1.39
"1713",1713,"Hell Girls",143000,163000,20000,1.99,13.99,70,0.59
"1714",1714,"Yury",110000,163000,53000,1.99,48.18,0,1.99
"1715",1715,"Full Spectrum Warrior",128000,163000,35000,9.99,27.34,75,2.49
"1716",1716,"FINAL FANTASY VI",124000,163000,39000,15.99,31.45,50,7.99
"1717",1717,"12 Labours of Hercules",156000,163000,7000,2.99,4.49,83,0.5
"1718",1718,"Cosmonautica",143000,163000,20000,9.99,13.99,50,4.99
"1719",1719,"Cook, Serve, Delicious! 2!!",131000,162000,31000,12.99,23.66,50,6.49
"1720",1720,"Late Shift",119000,162000,43000,12.99,36.13,40,7.79
"1721",1721,"The Deed",158000,162000,4000,0.99,2.53,51,0.49
"1722",1722,"Battle Brothers",102000,162000,60000,29.99,58.82,40,17.99
"1723",1723,"Styx: Shards of Darkness",105000,162000,57000,39.99,54.29,70,11.99
"1724",1724,"Beater Spirit",132000,161000,29000,5.99,21.97,90,0.59
"1725",1725,"Alone K.W.",105000,161000,56000,0.99,53.33,35,0.64
"1726",1726,"Relaxation balls",85000,161000,76000,0.99,89.41,0,0.99
"1727",1727,"Eight Mini Racers",133000,161000,28000,0.99,21.05,51,0.49
"1728",1728,"Planescape: Torment: Enhanced Edition",158000,161000,3000,19.99,1.9,75,4.99
"1729",1729,"NEO Scavenger",150000,161000,11000,14.99,7.33,75,3.74
"1730",1730,"Sig.NULL",142000,161000,19000,1.99,13.38,75,0.49
"1731",1731,"Force of Nature",113000,161000,48000,7.99,42.48,63,2.95
"1732",1732,"Marine Sharpshooter II: Jungle Warfare",130000,161000,31000,2.99,23.85,70,0.89
"1733",1733,"Game Tycoon 1.5",158000,160000,2000,0.99,1.27,51,0.49
"1734",1734,"Mystery Mine",139000,160000,21000,3.99,15.11,87,0.51
"1735",1735,"Bedlam",151000,160000,9000,12.99,5.96,90,1.29
"1736",1736,"EARTH DEFENSE FORCE 4.1 The Shadow of New Despair",124000,160000,36000,19.99,29.03,60,14.99
"1737",1737,"The Elder Scrolls V: Skyrim VR",99000,160000,61000,59.99,61.62,50,29.99
"1738",1738,"Archimedes",107000,160000,53000,2.99,49.53,70,0.89
"1739",1739,"Potatoman Seeks the Troof",154000,159000,5000,3.99,3.25,80,0.79
"1740",1740,"Magma Tsunami",120000,159000,39000,0.99,32.5,51,0.49
"1741",1741,"Unholy Heights",117000,159000,42000,3.99,35.9,30,2.79
"1742",1742,"Wolcen: Lords of Mayhem",93000,159000,66000,19.99,70.97,25,14.99
"1743",1743,"Lethal Brutal Racing",147000,159000,12000,5.99,8.16,90,0.59
"1744",1744,"Yooka-Laylee",121000,159000,38000,39.99,31.4,70,11.99
"1745",1745,"Cat Goes Platform",150000,159000,9000,1.99,6,75,0.49
"1746",1746,"Totem",150000,158000,8000,3.99,5.33,87,0.51
"1747",1747,"Warfront Defenders: Westerplatte",14000,158000,144000,4.99,1028.57,90,0.49
"1748",1748,"Fish Fillets 2",95000,158000,63000,4.99,66.32,80,0.99
"1749",1749,"Happy Room",126000,158000,32000,4.99,25.4,75,1.24
"1750",1750,"Cat or Bread?",64000,158000,94000,0.99,146.88,51,0.49
"1751",1751,"Beat Cop",147000,158000,11000,14.99,7.48,75,3.74
"1752",1752,"Westerado: Double Barreled",140000,158000,18000,14.99,12.86,80,2.99
"1753",1753,"BitRay2",125000,158000,33000,0.99,26.4,51,0.49
"1754",1754,"Bus Simulator 16",127000,157000,30000,17.99,23.62,50,7.49
"1755",1755,"Virtual Desktop",147000,157000,10000,14.99,6.8,50,7.49
"1756",1756,"Tank Blast",145000,157000,12000,4.99,8.28,90,0.49
"1757",1757,"Diluvion: Resubmerged",37000,157000,120000,19.99,324.32,85,2.99
"1758",1758,"Telltale Texas Hold ‘Em",111000,157000,46000,2.99,41.44,70,0.89
"1759",1759,"Bunch of Heroes",155000,157000,2000,4.99,1.29,0,4.99
"1760",1760,"Star Traders: Frontiers",19000,157000,138000,14.99,726.32,25,11.24
"1761",1761,"Year Walk",150000,157000,7000,5.99,4.67,50,2.99
"1762",1762,"F1 RACE STARS",150000,157000,7000,14.99,4.67,75,3.74
"1763",1763,"Sonic Mania",127000,157000,30000,19.99,23.62,66,6.79
"1764",1764,"Ring Runner: Flight of the Sages",146000,157000,11000,4.99,7.53,80,0.99
"1765",1765,"Dark Egypt",154000,156000,2000,2.99,1.3,84,0.49
"1766",1766,"GabeN: The Final Decision",133000,156000,23000,0.99,17.29,0,0.99
"1767",1767,"DEADBOLT",136000,156000,20000,9.99,14.71,55,4.49
"1768",1768,"Super Time Force Ultra",113000,156000,43000,14.99,38.05,66,5.09
"1769",1769,"Thea: The Awakening",140000,156000,16000,19.99,11.43,60,7.99
"1770",1770,"BLACKHOLE",97000,156000,59000,8.99,60.82,75,2.24
"1771",1771,"Merchants of Kaidan",154000,156000,2000,14.99,1.3,90,1.49
"1772",1772,"Jalopy",143000,156000,13000,14.99,9.09,50,7.49
"1773",1773,"OutDrive",134000,156000,22000,2.99,16.42,84,0.49
"1774",1774,"LiEat",133000,156000,23000,2.99,17.29,50,1.49
"1775",1775,"Wanda - A Beautiful Apocalypse",102000,155000,53000,1.99,51.96,90,0.99
"1776",1776,"Yeti Adventure",149000,155000,6000,0.99,4.03,51,0.49
"1777",1777,"Dungreed",62000,155000,93000,9.99,150,25,7.49
"1778",1778,"Street Fighter X Tekken",149000,155000,6000,29.99,4.03,80,5.99
"1779",1779,"Eurofighter Typhoon",97000,155000,58000,2.99,59.79,70,0.89
"1780",1780,"Game Corp DX",124000,155000,31000,2.99,25,75,0.74
"1781",1781,"Hunted: The Demon’s Forge",141000,155000,14000,4.99,9.93,75,1.24
"1782",1782,"Bell Ringer",130000,155000,25000,6.99,19.23,0,6.99
"1783",1783,"Dungeons & Dragons: Chronicles of Mystara",148000,155000,7000,14.99,4.73,67,4.94
"1784",1784,"The Wild Eight",128000,155000,27000,19.99,21.09,40,11.99
"1785",1785,"Star Ruler",151000,155000,4000,9.99,2.65,75,2.49
"1786",1786,"Fairy Bloom Freesia",128000,155000,27000,7.99,21.09,50,3.99
"1787",1787,"Eastside Hockey Manager",149000,155000,6000,19.99,4.03,75,4.99
"1788",1788,"PixelJunk Shooter",143000,155000,12000,8.99,8.39,85,1.34
"1789",1789,"Zup! 3",145000,155000,10000,0.99,6.9,30,0.69
"1790",1790,"LSDriver",112000,155000,43000,0.99,38.39,51,0.49
"1791",1791,"King's Bounty: Dark Side",146000,155000,9000,12.99,6.16,80,2.59
"1792",1792,"Insaniquarium Deluxe",129000,154000,25000,4.99,19.38,80,0.99
"1793",1793,"The Misadventures of P.B. Winterbottom",137000,154000,17000,4.99,12.41,75,1.24
"1794",1794,"Fairy Fencer F",129000,154000,25000,19.99,19.38,85,2.99
"1795",1795,"SAO Utils: Beta",32000,154000,122000,3.99,381.25,0,3.99
"1796",1796,"Zup! 2",147000,154000,7000,0.99,4.76,30,0.69
"1797",1797,"The Cat Lady",149000,154000,5000,9.99,3.36,77,2.29
"1798",1798,"Space Pirate Trainer",150000,154000,4000,14.99,2.67,50,7.49
"1799",1799,"Space Incident",144000,154000,10000,3.99,6.94,87,0.51
"1800",1800,"Suicide Guy",18000,153000,135000,4.99,750,40,2.99
"1801",1801,"We Were Here Too",55000,153000,98000,9.99,178.18,40,5.99
"1802",1802,"We Happy Few",113000,153000,40000,59.99,35.4,33,40.19
"1803",1803,"Eco",112000,153000,41000,29.99,36.61,0,29.99
"1804",1804,"Three Heroes",150000,153000,3000,4.99,2,90,0.49
"1805",1805,"Weapons Genius",109000,153000,44000,6.99,40.37,50,2.49
"1806",1806,"Fieldrunners",123000,152000,29000,4.99,23.58,50,2.49
"1807",1807,"Three Digits",142000,152000,10000,1.99,7.04,75,0.49
"1808",1808,"Spoiler Alert",141000,152000,11000,2.99,7.8,75,0.74
"1809",1809,"theHunter: Primal",124000,152000,28000,9.99,22.58,0,9.99
"1810",1810,"Klabi",150000,152000,2000,0.99,1.33,83,0.49
"1811",1811,"Eterium",136000,152000,16000,4.99,11.76,0,4.99
"1812",1812,"F1 2018",0,152000,152000,59.99,0,50,29.99
"1813",1813,"Kero Blaster",149000,152000,3000,9.99,2.01,40,5.99
"1814",1814,"Brick Rigs",111000,151000,40000,14.99,36.04,33,10.04
"1815",1815,"Soulbringer",143000,151000,8000,2.99,5.59,70,0.89
"1816",1816,"Last Answer",138000,151000,13000,4.99,9.42,0,4.99
"1817",1817,"Demolish & Build 2017",101000,151000,50000,19.99,49.5,80,3.99
"1818",1818,"Plazma Being",125000,151000,26000,4.99,20.8,90,0.49
"1819",1819,"Wings of Prey",146000,151000,5000,9.99,3.42,0,9.99
"1820",1820,"Trainz Simulator 12",147000,151000,4000,19.99,2.72,75,4.99
"1821",1821,"Bone: The Great Cow Race",135000,151000,16000,9.99,11.85,80,1.99
"1822",1822,"Disciples III - Resurrection",143000,151000,8000,14.99,5.59,85,2.24
"1823",1823,"Hyperdimension Neptunia U: Action Unleashed",124000,150000,26000,24.99,20.97,85,4.49
"1824",1824,"Little Racers STREET",142000,150000,8000,5.99,5.63,80,1.19
"1825",1825,"Platypus",140000,150000,10000,6.99,7.14,90,0.69
"1826",1826,"Deadly 30",145000,150000,5000,4.99,3.45,75,1.24
"1827",1827,"Millie",141000,150000,9000,3.99,6.38,88,0.49
"1828",1828,"Analogue: A Hate Story",147000,149000,2000,9.99,1.36,90,0.99
"1829",1829,"Age of Steel: Recharge",102000,149000,47000,6.99,46.08,0,6.99
"1830",1830,"Z",136000,149000,13000,6.99,9.56,90,0.69
"1831",1831,"Sword of the Stars II: Enhanced Edition",146000,149000,3000,19.99,2.05,75,4.99
"1832",1832,"Life Goes On: Done to Death",83000,149000,66000,12.99,79.52,80,2.59
"1833",1833,"FarSky",146000,149000,3000,4.99,2.05,50,2.49
"1834",1834,"Cities XXL",125000,149000,24000,9.99,19.2,70,2.99
"1835",1835,"Dungeons 3",101000,149000,48000,39.99,47.52,70,11.99
"1836",1836,"Super Amazing Wagon Adventure",147000,149000,2000,2.99,1.36,66,1.01
"1837",1837,"Crash Bandicoot N. Sane Trilogy",0,148000,148000,39.99,0,35,25.99
"1838",1838,"Defend The Highlands",144000,148000,4000,9.99,2.78,75,2.49
"1839",1839,"Agatha Christie - The ABC Murders",137000,148000,11000,14.99,8.03,70,4.49
"1840",1840,"The Blue Flamingo",143000,148000,5000,4.99,3.5,80,0.99
"1841",1841,"X4: Foundations",0,147000,147000,49.99,0,0,49.99
"1842",1842,"Fearless Fantasy",133000,147000,14000,6.99,10.53,75,1.74
"1843",1843,"Lucius II",125000,147000,22000,19.99,17.6,85,2.99
"1844",1844,"Way of Hero",129000,147000,18000,0.99,13.95,51,0.49
"1845",1845,"The Evil Within 2",125000,147000,22000,59.99,17.6,67,19.79
"1846",1846,"HellGunner",118000,147000,29000,0.99,24.58,51,0.49
"1847",1847,"The Witcher Adventure Game",145000,147000,2000,9.99,1.38,75,2.49
"1848",1848,"Ice Lakes",113000,146000,33000,14.99,29.2,50,7.49
"1849",1849,"Citadel: Forged with Fire",110000,146000,36000,24.99,32.73,60,9.99
"1850",1850,"Anna's Quest",112000,146000,34000,19.99,30.36,90,3.99
"1851",1851,"Expeditions: Conquistador",144000,146000,2000,19.99,1.39,80,3.99
"1852",1852,"Medieval: Total War - Collection",119000,146000,27000,9.99,22.69,75,2.49
"1853",1853,"OVERKILL's The Walking Dead",0,146000,146000,29.99,0,0,29.99
"1854",1854,"Patrician III",112000,145000,33000,4.99,29.46,80,0.99
"1855",1855,"Super House of Dead Ninjas",118000,145000,27000,6.99,22.88,90,0.69
"1856",1856,"Medieval Defenders",136000,145000,9000,4.99,6.62,90,0.49
"1857",1857,"Assassin's Creed Freedom Cry",135000,145000,10000,14.99,7.41,60,5.99
"1858",1858,"Hotel Anatolia",102000,145000,43000,0.99,42.16,51,0.49
"1859",1859,"Alchemyland",142000,145000,3000,0.99,2.11,30,0.69
"1860",1860,"Hand of Fate 2",111000,144000,33000,29.99,29.73,25,22.49
"1861",1861,"The Blackwell Legacy",141000,144000,3000,4.99,2.13,80,0.99
"1862",1862,"Rake",124000,144000,20000,4.99,16.13,50,2.49
"1863",1863,"Storm Of Spears RPG",141000,144000,3000,1.99,2.13,75,0.49
"1864",1864,"Tea Party Simulator 2015",129000,144000,15000,9.99,11.63,80,1.99
"1865",1865,"Trackmania United Forever Star Edition",137000,144000,7000,29.99,5.11,70,8.99
"1866",1866,"SHENZHEN I/O",86000,144000,58000,14.99,67.44,67,4.94
"1867",1867,"Grotesque Tactics: Evil Heroes",141000,144000,3000,9.99,2.13,80,1.99
"1868",1868,"SpellForce 2 - Demons of the Past",124000,144000,20000,19.99,16.13,80,3.99
"1869",1869,"Out of the Park Baseball 17",111000,144000,33000,19.99,29.73,0,19.99
"1870",1870,"Airstrike HD",130000,144000,14000,1.99,10.77,75,0.49
"1871",1871,"Dungeon Souls",139000,144000,5000,12.99,3.6,80,2.59
"1872",1872,"Nightmares from the Deep: The Cursed Heart",126000,143000,17000,9.99,13.49,70,2.99
"1873",1873,"Sonic Lost World",124000,143000,19000,29.99,15.32,75,7.49
"1874",1874,"Ratz Instagib",111000,143000,32000,8.99,28.83,90,0.89
"1875",1875,"Blitzkrieg Anthology",108000,143000,35000,4.99,32.41,70,1.49
"1876",1876,"Wild West Online",66000,143000,77000,19.99,116.67,50,14.99
"1877",1877,"LOOM",121000,143000,22000,5.99,18.18,66,2.03
"1878",1878,"Reptilians Must Die!",123000,142000,19000,1.99,15.45,75,0.49
"1879",1879,"Dig or Die",125000,142000,17000,11.99,13.6,10,10.79
"1880",1880,"Desperados: Wanted Dead or Alive",122000,142000,20000,4.99,16.39,80,0.99
"1881",1881,"Brothers in Arms: Hell's Highway",129000,142000,13000,9.99,10.08,75,2.49
"1882",1882,"What's under your blanket 2 !?",72000,142000,70000,0.99,97.22,30,0.69
"1883",1883,"Absolute Drift",135000,142000,7000,11.99,5.19,60,4.79
"1884",1884,"klocki",124000,142000,18000,0.99,14.52,25,0.74
"1885",1885,"Giana Sisters: Twisted Dreams - Rise of the Owlverlord",138000,142000,4000,4.99,2.9,75,1.24
"1886",1886,"STEINS;GATE",119000,141000,22000,29.99,18.49,60,11.99
"1887",1887,"Kindergarten",134000,141000,7000,4.99,5.22,30,3.49
"1888",1888,"Trapped Dead",137000,141000,4000,4.99,2.92,80,0.99
"1889",1889,"Frisky Business",113000,141000,28000,4.99,24.78,80,0.99
"1890",1890,"Hob",95000,141000,46000,19.99,48.42,50,9.99
"1891",1891,"Anykey Simulator",137000,141000,4000,2.99,2.92,83,0.5
"1892",1892,"Life is Strange 2",0,141000,141000,7.99,0,50,3.99
"1893",1893,"The Journey Down: Chapter Two",135000,141000,6000,19.99,4.44,50,9.99
"1894",1894,"Space Quest Collection",130000,140000,10000,19.99,7.69,75,4.99
"1895",1895,"GORN",97000,140000,43000,19.99,44.33,25,14.99
"1896",1896,"Simple Ball: Extended Edition",59000,140000,81000,1.99,137.29,75,0.49
"1897",1897,"Sleight",114000,140000,26000,0.99,22.81,51,0.49
"1898",1898,"Space Hulk: Ascension",113000,140000,27000,29.99,23.89,80,5.99
"1899",1899,"Zombie Party",119000,140000,21000,9.99,17.65,80,1.99
"1900",1900,"Obduction",102000,140000,38000,29.99,37.25,65,10.49
"1901",1901,"World of Subways 3 – London Underground Circle Line",106000,140000,34000,14.99,32.08,35,10.04
"1902",1902,"The Novelist",137000,139000,2000,9.99,1.46,85,1.49
"1903",1903,"Rising World",117000,139000,22000,14.99,18.8,33,10.04
"1904",1904,"Kidnapped",113000,139000,26000,2.99,23.01,74,0.77
"1905",1905,"The Dream Machine: Chapter 1 & 2",134000,139000,5000,3.99,3.73,75,0.99
"1906",1906,"Warhammer 40,000: Regicide",133000,139000,6000,9.99,4.51,50,7.49
"1907",1907,"Brine",119000,139000,20000,3.99,16.81,0,3.99
"1908",1908,"Sakura Santa",137000,139000,2000,9.99,1.46,75,2.49
"1909",1909,"We Need To Go Deeper",99000,139000,40000,9.99,40.4,35,6.49
"1910",1910,"Fortune Summoners",134000,138000,4000,19.99,2.99,80,3.99
"1911",1911,"Planet Ancyra Chronicles",112000,138000,26000,9.99,23.21,80,1.99
"1912",1912,"King's Guard TD",127000,138000,11000,2.99,8.66,80,0.49
"1913",1913,"Mars Industries",135000,138000,3000,1.99,2.22,75,0.49
"1914",1914,"Resident Evil: Operation Raccoon City",133000,138000,5000,29.99,3.76,80,5.99
"1915",1915,"Haydee",94000,138000,44000,14.99,46.81,80,2.99
"1916",1916,"12 Labours of Hercules III: Girl Power",96000,138000,42000,2.99,43.75,83,0.5
"1917",1917,"Battlerite Royale",0,138000,138000,19.99,0,50,9.99
"1918",1918,"AquaNox 2: Revelation",66000,137000,71000,4.99,107.58,80,0.99
"1919",1919,"Primordia",129000,137000,8000,9.99,6.2,75,2.49
"1920",1920,"Melody's Escape",126000,137000,11000,9.99,8.73,66,3.39
"1921",1921,"Anoxemia",134000,137000,3000,3.99,2.24,87,0.51
"1922",1922,"Chainsaw Warrior",123000,137000,14000,4.99,11.38,90,0.49
"1923",1923,"AquaNox",116000,137000,21000,4.99,18.1,80,0.99
"1924",1924,"Bridge Project",127000,137000,10000,19.99,7.87,75,4.99
"1925",1925,"Gunspell - Steam Edition",132000,136000,4000,14.99,3.03,90,1.49
"1926",1926,"GUILTY GEAR Xrd -SIGN-",116000,136000,20000,29.99,17.24,80,5.99
"1927",1927,"Marooners",91000,136000,45000,9.99,49.45,70,2.99
"1928",1928,"RONIN",128000,136000,8000,12.99,6.25,75,3.24
"1929",1929,"Krampus",128000,136000,8000,4.99,6.25,90,0.49
"1930",1930,"Megadimension Neptunia VII",88000,136000,48000,29.99,54.55,75,7.49
"1931",1931,"Mr.President!",102000,136000,34000,4.99,33.33,80,0.99
"1932",1932,"THE KING OF FIGHTERS 2002 UNLIMITED MATCH",128000,136000,8000,14.99,6.25,70,4.49
"1933",1933,"Star Wolves 3: Civil War",133000,136000,3000,4.99,2.26,80,0.99
"1934",1934,"Last Day of June",44000,136000,92000,19.99,209.09,70,5.99
"1935",1935,"Ni no Kuni II: Revenant Kingdom",99000,136000,37000,59.99,37.37,50,29.99
"1936",1936,"Drawful 2",120000,135000,15000,9.99,12.5,50,4.99
"1937",1937,"Men of War: Condemned Heroes",132000,135000,3000,7.99,2.27,80,1.59
"1938",1938,"Deadly Animal Duel",113000,135000,22000,0.99,19.47,51,0.49
"1939",1939,"Rabi-Ribi",121000,135000,14000,17.99,11.57,38,11.15
"1940",1940,"Coma: Mortuary",122000,135000,13000,5.99,10.66,90,0.59
"1941",1941,"Lucy -The Eternity She Wished For-",111000,135000,24000,9.99,21.62,55,4.49
"1942",1942,"Crimsonland",118000,135000,17000,13.99,14.41,80,2.79
"1943",1943,"Sherlock Holmes: Crimes and Punishments",110000,135000,25000,29.99,22.73,50,14.99
"1944",1944,"Sentinels of the Multiverse",120000,135000,15000,9.99,12.5,90,0.99
"1945",1945,"Dinosaur Hunt",124000,135000,11000,0.99,8.87,51,0.49
"1946",1946,"10,000,000",127000,134000,7000,4.99,5.51,0,4.99
"1947",1947,"Crimzon Clover WORLD IGNITION",128000,134000,6000,9.99,4.69,80,1.99
"1948",1948,"Castle of Illusion",132000,134000,2000,14.99,1.52,75,3.74
"1949",1949,"Case #8",127000,134000,7000,3.99,5.51,88,0.49
"1950",1950,"Odallus: The Dark Call",99000,134000,35000,9.99,35.35,70,2.99
"1951",1951,"Gorogoa",65000,134000,69000,14.99,106.15,45,8.24
"1952",1952,"Theatre of War",89000,134000,45000,3.99,50.56,80,0.79
"1953",1953,"Galactic Inheritors",92000,134000,42000,19.99,45.65,75,4.99
"1954",1954,"Burgers",113000,133000,20000,2.99,17.7,0,2.99
"1955",1955,"Kathy Rain",126000,133000,7000,14.99,5.56,75,3.74
"1956",1956,"OneScreen Wagons",21000,133000,112000,0.99,533.33,51,0.49
"1957",1957,"Majesty 2",108000,133000,25000,9.99,23.15,75,2.49
"1958",1958,"Holdfast: Nations At War",117000,133000,16000,19.99,13.68,50,9.99
"1959",1959,"Crazy Machines 2",131000,133000,2000,9.99,1.53,50,4.99
"1960",1960,"Circuits",131000,133000,2000,4.99,1.53,75,1.24
"1961",1961,"Cat Quest",69000,133000,64000,12.99,92.75,60,5.19
"1962",1962,"Tomb Joe",124000,133000,9000,0.99,7.26,51,0.49
"1963",1963,"Grim Legends: The Forsaken Bride",130000,133000,3000,9.99,2.31,60,3.99
"1964",1964,"SUPERHOT VR",110000,132000,22000,24.99,20,33,16.74
"1965",1965,"Crazy Oafish Ultra Blocks: Big Sale",8000,132000,124000,4.99,1550,90,0.49
"1966",1966,"Reassembly",130000,132000,2000,14.99,1.54,70,4.49
"1967",1967,"Deathtrap",124000,132000,8000,19.99,6.45,75,4.99
"1968",1968,"Teddy Floppy Ear - The Race",122000,132000,10000,4.99,8.2,90,0.49
"1969",1969,"F1 2011",127000,132000,5000,14.99,3.94,75,3.74
"1970",1970,"Rain World",110000,132000,22000,19.99,20,60,7.99
"1971",1971,"Conjuntalia",57000,132000,75000,0.99,131.58,15,0.84
"1972",1972,"Arcade Tale",83000,132000,49000,0.99,59.04,51,0.49
"1973",1973,"RPG Maker XP",56000,132000,76000,24.99,135.71,80,4.99
"1974",1974,"Life is Feudal: Forest Village",127000,132000,5000,24.99,3.94,60,9.99
"1975",1975,"Act of Aggression - Reboot Edition",123000,131000,8000,29.99,6.5,75,7.49
"1976",1976,"古剑奇谭(GuJian)",82000,131000,49000,11.99,59.76,55,5.39
"1977",1977,"CHRONO TRIGGER",33000,131000,98000,14.99,296.97,50,7.49
"1978",1978,"Shadowgate",128000,131000,3000,14.99,2.34,80,2.99
"1979",1979,"Orbt XL",129000,131000,2000,0.99,1.55,51,0.49
"1980",1980,"Arcanum: Of Steamworks and Magick Obscura",113000,131000,18000,5.99,15.93,75,1.49
"1981",1981,"Killing Time",98000,131000,33000,1.99,33.67,70,0.59
"1982",1982,"Astebreed: Definitive Edition",124000,131000,7000,19.99,5.65,50,9.99
"1983",1983,"Death Coming",109000,131000,22000,6.99,20.18,55,3.14
"1984",1984,"Call of Juarez",109000,130000,21000,9.99,19.27,75,2.49
"1985",1985,"X-Plane 11",91000,130000,39000,59.99,42.86,34,39.59
"1986",1986,"Witch It",90000,130000,40000,14.99,44.44,50,7.49
"1987",1987,"Other Tanks",114000,130000,16000,1.99,14.04,75,0.49
"1988",1988,"NOBUNAGA'S AMBITION: Sphere of Influence - Ascension / 信長の野望･創造 戦国立志伝",76000,130000,54000,59.99,71.05,60,23.99
"1989",1989,"FURIDASHI: Drift Cyber Sport",46000,130000,84000,14.99,182.61,37,9.44
"1990",1990,"Sword of the Stars: Complete Collection",124000,129000,5000,9.99,4.03,75,2.49
"1991",1991,"OKAMI HD / 大神 絶景版",93000,129000,36000,19.99,38.71,30,13.99
"1992",1992,"Pathfinder Adventures",21000,129000,108000,14.99,514.29,67,4.94
"1993",1993,"Existence speed",3000,129000,126000,0.99,4200,43,0.56
"1994",1994,"Desktop Dungeons",114000,129000,15000,14.99,13.16,50,7.49
"1995",1995,"Nongünz",113000,129000,16000,6.99,14.16,30,4.89
"1996",1996,"Indiana Jones and the Last Crusade",36000,129000,93000,5.99,258.33,66,2.03
"1997",1997,"Thumper",75000,129000,54000,19.99,72,75,4.99
"1998",1998,"Moonlighter",63000,129000,66000,19.99,104.76,30,13.99
"1999",1999,"Blaite",88000,129000,41000,0.99,46.59,51,0.49
"2000",2000,"Iron Impact",105000,129000,24000,3.99,22.86,87,0.51
"2001",2001,"NARUTO: Ultimate Ninja STORM",41000,129000,88000,19.99,214.63,50,9.99
"2002",2002,"Chronology",124000,128000,4000,4.99,3.23,80,0.99
"2003",2003,"Monstrum",80000,128000,48000,17.99,60,80,3.59
"2004",2004,"Girls Like Robots",92000,128000,36000,6.99,39.13,80,1.39
"2005",2005,"Sword Art Online: Hollow Realization Deluxe Edition",91000,128000,37000,49.99,40.66,60,19.99
"2006",2006,"Dracula's Legacy",106000,128000,22000,2.99,20.75,83,0.5
"2007",2007,"Bardbarian",113000,128000,15000,7.99,13.27,50,3.99
"2008",2008,"Bleed",113000,128000,15000,4.99,13.27,70,1.49
"2009",2009,"Fruit Arranger",91000,128000,37000,0.99,40.66,51,0.49
"2010",2010,"Axis Game Factory's AGFPRO v3",117000,128000,11000,9.99,9.4,0,9.99
"2011",2011,"Albert and Otto",118000,128000,10000,4.99,8.47,80,0.99
"2012",2012,"Heavy Bullets",117000,128000,11000,9.99,9.4,75,2.49
"2013",2013,"Starpoint Gemini Warlords",93000,128000,35000,34.99,37.63,75,8.74
"2014",2014,"Feed and Grow: Fish",103000,128000,25000,14.99,24.27,0,14.99
"2015",2015,"Once in Yaissor",77000,128000,51000,0.99,66.23,37,0.62
"2016",2016,"Action Henk",106000,127000,21000,14.99,19.81,75,3.74
"2017",2017,"Enforcer: Police Crime Action",123000,127000,4000,19.99,3.25,80,3.99
"2018",2018,"Naval Warfare",121000,127000,6000,2.99,4.96,80,0.59
"2019",2019,"Controller Companion",120000,127000,7000,2.99,5.83,33,2
"2020",2020,"Halo: Spartan Strike",113000,127000,14000,2.99,12.39,60,1.19
"2021",2021,"Evil Maze",118000,127000,9000,1.99,7.63,55,0.89
"2022",2022,"Flotilla",98000,127000,29000,9.99,29.59,66,3.39
"2023",2023,"Schein",118000,127000,9000,8.99,7.63,80,1.79
"2024",2024,"Decay: The Mare",119000,127000,8000,4.99,6.72,80,0.99
"2025",2025,"Universal Combat CE",82000,127000,45000,9.99,54.88,50,4.99
"2026",2026,"Wolf Simulator",85000,127000,42000,3.99,49.41,87,0.51
"2027",2027,"Titan Attacks!",125000,127000,2000,9.99,1.6,63,3.69
"2028",2028,"Subsistence",86000,127000,41000,13.99,47.67,20,11.19
"2029",2029,"Divide By Sheep",97000,127000,30000,4.99,30.93,50,2.49
"2030",2030,"Expeditions: Viking",92000,126000,34000,29.99,36.96,50,14.99
"2031",2031,"STAR WARS SHADOWS OF THE EMPIRE",76000,126000,50000,5.99,65.79,66,2.03
"2032",2032,"Jagged Alliance: Crossfire",94000,126000,32000,14.99,34.04,80,2.99
"2033",2033,"Runaway, The Dream of The Turtle",103000,126000,23000,9.99,22.33,80,1.99
"2034",2034,"Cucumber Blues",123000,126000,3000,0.99,2.44,51,0.49
"2035",2035,"Runaway: A Twist of Fate",124000,126000,2000,9.99,1.61,80,1.99
"2036",2036,"The First Templar - Steam Special Edition",121000,126000,5000,9.99,4.13,80,1.99
"2037",2037,"FAR: Lone Sails",58000,126000,68000,14.99,117.24,25,11.24
"2038",2038,"FootLOL: Epic Fail League",123000,125000,2000,9.99,1.63,60,3.99
"2039",2039,"ULTIMATE MARVEL VS. CAPCOM 3",1e+05,125000,25000,24.99,25,60,9.99
"2040",2040,"Vagante",76000,125000,49000,14.99,64.47,34,9.89
"2041",2041,"Miasmata",122000,125000,3000,14.99,2.46,85,2.24
"2042",2042,"DRAGON QUEST XI: Echoes of an Elusive Age - Digital Edition of Light",0,125000,125000,59.99,0,30,41.99
"2043",2043,"The Incredible Adventures of Van Helsing III",99000,125000,26000,14.99,26.26,75,3.74
"2044",2044,"DeathSpank",123000,125000,2000,14.99,1.63,75,3.74
"2045",2045,"Coin Crypt",123000,125000,2000,9.99,1.63,75,2.49
"2046",2046,"Alchemy Mysteries: Prague Legends",121000,125000,4000,1.99,3.31,75,0.49
"2047",2047,"Corporate Lifestyle Simulator",123000,125000,2000,4.99,1.63,33,3.34
"2048",2048,"Triangle",121000,125000,4000,1.99,3.31,75,0.49
"2049",2049,"Dogfight 1942",122000,125000,3000,9.99,2.46,90,0.99
"2050",2050,"UBERMOSH",117000,125000,8000,0.99,6.84,90,0.49
"2051",2051,"Sakura Nova",111000,125000,14000,14.99,12.61,50,7.49
"2052",2052,"Greed: Black Border",121000,125000,4000,4.99,3.31,75,1.24
"2053",2053,"Hover Hazard",105000,125000,20000,1.99,19.05,75,0.49
"2054",2054,"Fallout 4 VR",64000,124000,60000,59.99,93.75,50,29.99
"2055",2055,"EM: Shader Attack",108000,124000,16000,1.99,14.81,75,0.49
"2056",2056,"SOULCALIBUR VI",0,124000,124000,59.99,0,30,41.99
"2057",2057,"Chika Militant Cockroach",101000,124000,23000,1.99,22.77,75,0.49
"2058",2058,"Plug & Play",98000,124000,26000,2.99,26.53,33,2
"2059",2059,"Rune Classic",96000,124000,28000,9.99,29.17,80,1.99
"2060",2060,"Sunrider: Liberation Day - Captain's Edition",106000,124000,18000,24.99,16.98,75,6.24
"2061",2061,"Putrefaction",108000,124000,16000,0.99,14.81,51,0.49
"2062",2062,"Kairo",122000,124000,2000,4.99,1.64,80,0.99
"2063",2063,"Dragon Knight",114000,124000,10000,3.99,8.77,70,1.19
"2064",2064,"Moto Racer 4",90000,124000,34000,14.99,37.78,40,8.99
"2065",2065,"Geometry Wars 3: Dimensions Evolved",104000,124000,20000,14.99,19.23,50,7.49
"2066",2066,"Lobotomy Corporation | Monster Management Simulation",96000,123000,27000,24.99,28.13,25,18.74
"2067",2067,"Neverwinter Nights: Enhanced Edition",34000,123000,89000,19.99,261.76,66,6.79
"2068",2068,"Space Pirates And Zombies 2",84000,123000,39000,19.99,46.43,50,9.99
"2069",2069,"! That Bastard Is Trying To Steal Our Gold !",85000,123000,38000,3.99,44.71,60,1.59
"2070",2070,"Pester",103000,123000,20000,0.99,19.42,51,0.49
"2071",2071,"Software Inc.",98000,123000,25000,13.99,25.51,0,13.99
"2072",2072,"Lara Croft GO",99000,123000,24000,9.99,24.24,75,2.49
"2073",2073,"How To Survive: Third Person Standalone",108000,123000,15000,9.99,13.89,90,0.99
"2074",2074,"Neverending Nightmares",117000,123000,6000,14.99,5.13,75,3.74
"2075",2075,"Theatre of War 2: Africa 1943",121000,123000,2000,4.99,1.65,80,0.99
"2076",2076,"Slash It 2",105000,123000,18000,4.99,17.14,90,0.49
"2077",2077,"Tattletail",98000,123000,25000,4.99,25.51,50,2.49
"2078",2078,"Drift (Over) Drive",99000,123000,24000,0.99,24.24,51,0.49
"2079",2079,"The Baconing",1e+05,123000,23000,14.99,23,0,14.99
"2080",2080,"Manhunter",109000,123000,14000,4.99,12.84,90,0.49
"2081",2081,"Worlds Adrift",88000,123000,35000,24.99,39.77,25,18.74
"2082",2082,"Sakura Shrine Girls",118000,123000,5000,9.99,4.24,60,3.99
"2083",2083,"CarX Drift Racing Online",85000,123000,38000,9.99,44.71,50,4.99
"2084",2084,"The chronicles of Emerland. Solitaire.",118000,122000,4000,3.99,3.39,50,1.99
"2085",2085,"Fantasy Kingdom Simulator",115000,122000,7000,0.99,6.09,51,0.49
"2086",2086,"Shark Attack Deathmatch 2",105000,122000,17000,2.99,16.19,50,1.49
"2087",2087,"Skyward Collapse",103000,122000,19000,4.99,18.45,80,0.99
"2088",2088,"Munin",112000,122000,10000,4.99,8.93,90,0.49
"2089",2089,"Over 9000 Zombies!",112000,122000,10000,1.99,8.93,75,0.49
"2090",2090,"The Apogee Throwback Pack",105000,122000,17000,9.99,16.19,80,1.99
"2091",2091,"NecroVisioN: Lost Company",114000,122000,8000,6.99,7.02,80,1.39
"2092",2092,"Wizardry 8",116000,122000,6000,9.99,5.17,80,1.99
"2093",2093,"Motorama",105000,122000,17000,19.99,16.19,90,1.99
"2094",2094,"Aveyond 3-2: Gates of Night",114000,122000,8000,9.99,7.02,80,1.99
"2095",2095,"Caesar 3",104000,122000,18000,5.99,17.31,35,3.89
"2096",2096,"Inquisitor",120000,122000,2000,9.99,1.67,75,2.49
"2097",2097,"Employee Recycling Center",36000,122000,86000,0.99,238.89,51,0.49
"2098",2098,"Shadwen",107000,121000,14000,16.99,13.08,75,4.24
"2099",2099,"See No Evil",116000,121000,5000,0.99,4.31,75,0.49
"2100",2100,"Windosill",113000,121000,8000,2.99,7.08,67,0.98
"2101",2101,"Madrobot X",99000,121000,22000,2.99,22.22,70,0.89
"2102",2102,"Inexistence",34000,121000,87000,2.99,255.88,83,0.5
"2103",2103,"Age of Wonders Shadow Magic",117000,121000,4000,9.99,3.42,80,1.99
"2104",2104,"N++ (NPLUSPLUS)",108000,121000,13000,14.99,12.04,50,7.49
"2105",2105,"Crashlands",114000,121000,7000,14.99,6.14,34,9.89
"2106",2106,"Influent",106000,121000,15000,9.99,14.15,75,2.49
"2107",2107,"Squirbs",114000,121000,7000,4.99,6.14,90,0.49
"2108",2108,"THE KING OF FIGHTERS '98 ULTIMATE MATCH FINAL EDITION",116000,121000,5000,14.99,4.31,70,4.49
"2109",2109,"Voxel Warfare Online",1e+05,121000,21000,4.99,21,90,0.49
"2110",2110,"Intralism",103000,121000,18000,2.99,17.48,83,0.5
"2111",2111,"Railway Empire",73000,120000,47000,49.99,64.38,50,24.99
"2112",2112,"The Red Strings Club",33000,120000,87000,14.99,263.64,66,5.09
"2113",2113,"- Arcane Raise -",114000,120000,6000,2.99,5.26,83,0.5
"2114",2114,"Age of Wonders",108000,120000,12000,5.99,11.11,80,1.19
"2115",2115,"Cossacks II: Battle for Europe",102000,120000,18000,4.99,17.65,75,1.24
"2116",2116,"Clones",118000,120000,2000,0.99,1.69,51,0.49
"2117",2117,"Tribal Pass",117000,119000,2000,5.99,1.71,90,0.59
"2118",2118,"Dawn of Discovery",105000,119000,14000,9.99,13.33,75,2.49
"2119",2119,"Rogue Stormers",92000,119000,27000,19.99,29.35,75,4.99
"2120",2120,"Jones On Fire",89000,119000,30000,2.99,33.71,75,0.74
"2121",2121,"My Name is You",117000,119000,2000,5.99,1.71,90,0.59
"2122",2122,"Hard Reset Redux",76000,119000,43000,19.99,56.58,90,1.99
"2123",2123,"Impire",112000,119000,7000,19.99,6.25,75,4.99
"2124",2124,"Save Jesus",116000,119000,3000,1.99,2.59,75,0.49
"2125",2125,"Castlevania: Lords of Shadow – Mirror of Fate HD",107000,119000,12000,14.99,11.21,80,2.99
"2126",2126,"Hell`s Little Story",115000,119000,4000,2.99,3.48,83,0.5
"2127",2127,"Amber Tail Adventure",89000,119000,30000,0.99,33.71,40,0.59
"2128",2128,"Anomaly Warzone Earth Mobile Campaign",116000,119000,3000,4.99,2.59,85,0.74
"2129",2129,"Hot Tin Roof: The Cat That Wore A Fedora",114000,119000,5000,14.99,4.39,75,3.74
"2130",2130,"Ninja Pizza Girl",116000,119000,3000,6.99,2.59,85,1.04
"2131",2131,"Solarix",1e+05,119000,19000,19.99,19,90,1.99
"2132",2132,"Steredenn",86000,119000,33000,12.99,38.37,70,3.89
"2133",2133,"Disciples II: Rise of the Elves",117000,119000,2000,6.99,1.71,85,1.04
"2134",2134,"SKYHILL",92000,119000,27000,14.99,29.35,90,2.99
"2135",2135,"Bloody Good Time",116000,118000,2000,4.99,1.72,66,1.69
"2136",2136,"Scourge: Outbreak",113000,118000,5000,7.99,4.42,50,3.99
"2137",2137,"Combat Wings: Battle of Britain",94000,118000,24000,4.99,25.53,85,0.74
"2138",2138,"Space Codex",74000,118000,44000,0.99,59.46,51,0.49
"2139",2139,"Sherlock Holmes: The Awakened - Remastered Edition",105000,118000,13000,9.99,12.38,75,2.49
"2140",2140,"Super Duper Party Pooper",104000,118000,14000,0.99,13.46,51,0.49
"2141",2141,"Dead Rising 4",96000,118000,22000,29.99,22.92,34,19.79
"2142",2142,"Exanima",71000,118000,47000,14.99,66.2,0,14.99
"2143",2143,"FBI MANIA",86000,117000,31000,0.99,36.05,51,0.49
"2144",2144,"Spin Rush",105000,117000,12000,4.99,11.43,90,0.49
"2145",2145,"Gazing from beyond",20000,117000,97000,1.99,485,50,0.99
"2146",2146,"The Next BIG Thing",87000,117000,30000,9.99,34.48,80,1.99
"2147",2147,"Cossacks II: Napoleonic Wars",69000,117000,48000,4.99,69.57,75,1.24
"2148",2148,"SPACECOM",110000,117000,7000,9.99,6.36,85,1.49
"2149",2149,"Clicker Heroes 2",0,117000,117000,29.99,0,0,29.99
"2150",2150,"GUILTY GEAR XX ACCENT CORE PLUS R",112000,117000,5000,14.99,4.46,80,2.99
"2151",2151,"//SNOWFLAKE TATTOO//",110000,117000,7000,4.99,6.36,85,0.74
"2152",2152,"Lifeless Planet Premier Edition",107000,117000,10000,19.99,9.35,75,4.99
"2153",2153,"Alpacapaca Dash",99000,117000,18000,0.99,18.18,20,0.79
"2154",2154,"WORLD END ECONOMiCA episode.01",89000,117000,28000,12.99,31.46,75,3.24
"2155",2155,"Alpha Runner",77000,116000,39000,0.99,50.65,51,0.49
"2156",2156,"Grim Legends 2: Song of the Dark Swan",99000,116000,17000,9.99,17.17,60,3.99
"2157",2157,"Office Battle",105000,116000,11000,0.99,10.48,51,0.49
"2158",2158,"RiME",72000,116000,44000,29.99,61.11,67,9.89
"2159",2159,"Marvel's Guardians of the Galaxy: The Telltale Series",74000,116000,42000,14.99,56.76,50,12.49
"2160",2160,"Dex",72000,116000,44000,19.99,61.11,90,1.99
"2161",2161,"Farm Together",52000,116000,64000,19.99,123.08,10,14.99
"2162",2162,"Everything",114000,116000,2000,14.99,1.75,75,3.74
"2163",2163,"Gaokao.Love.100Days",109000,116000,7000,9.99,6.42,25,7.49
"2164",2164,"Purgatory II",27000,116000,89000,0.99,329.63,51,0.49
"2165",2165,"Card City Nights",98000,116000,18000,4.99,18.37,50,1.99
"2166",2166,"Dangerous High School Girls in Trouble!",110000,116000,6000,19.99,5.45,50,9.99
"2167",2167,"PULSAR: Lost Colony",111000,116000,5000,24.99,4.5,40,14.99
"2168",2168,"Beyond Eyes",114000,116000,2000,14.99,1.75,75,3.74
"2169",2169,"Zanzarah: The Hidden Portal",69000,115000,46000,7.99,66.67,90,0.79
"2170",2170,"Zenge",1e+05,115000,15000,0.99,15,30,0.69
"2171",2171,"Clickteam Fusion 2.5",93000,115000,22000,99.99,23.66,66,33.99
"2172",2172,"GT Legends",65000,115000,50000,7.99,76.92,50,3.99
"2173",2173,"Real Boxing",108000,115000,7000,4.99,6.48,30,3.49
"2174",2174,"The Jackbox Party Pack 4",78000,115000,37000,24.99,47.44,45,13.74
"2175",2175,"Monster Prom",42000,115000,73000,11.99,173.81,15,10.19
"2176",2176,"The Park",101000,115000,14000,12.99,13.86,70,3.89
"2177",2177,"Critical Mass",112000,115000,3000,1.99,2.68,0,1.99
"2178",2178,"Marlow Briggs and the Mask of Death",105000,115000,10000,4.99,9.52,0,4.99
"2179",2179,"Sudoku Universe / 数独宇宙",15000,115000,1e+05,1.99,666.67,75,0.49
"2180",2180,"The Curious Expedition",107000,115000,8000,14.99,7.48,50,7.49
"2181",2181,"Sherlock Holmes versus Jack the Ripper",107000,115000,8000,9.99,7.48,75,2.49
"2182",2182,"Down To One",112000,115000,3000,0.99,2.68,0,0.99
"2183",2183,"Rollers of the Realm",112000,115000,3000,9.99,2.68,80,1.99
"2184",2184,"American Conquest",72000,115000,43000,4.99,59.72,75,1.24
"2185",2185,"Vikings - Wolves of Midgard",71000,115000,44000,29.99,61.97,80,5.99
"2186",2186,"The Tape",95000,114000,19000,0.99,20,51,0.49
"2187",2187,"Zero Gear",112000,114000,2000,4.99,1.79,80,0.99
"2188",2188,"Cubemen 2",87000,114000,27000,7.99,31.03,80,1.59
"2189",2189,"CryptoMoneya",77000,114000,37000,0.99,48.05,30,0.69
"2190",2190,"Kingdom Rush Frontiers",89000,114000,25000,9.99,28.09,75,2.49
"2191",2191,"Linea, the Game",91000,114000,23000,1.99,25.27,75,0.49
"2192",2192,"STAR WARS: Rebel Assault I + II",109000,114000,5000,9.99,4.59,66,3.39
"2193",2193,"Gunnheim",105000,114000,9000,9.99,8.57,90,0.99
"2194",2194,"Total Annihilation",90000,113000,23000,4.99,25.56,70,1.49
"2195",2195,"Panzer Corps",107000,113000,6000,19.99,5.61,90,1.99
"2196",2196,"Caveman World: Mountains of Unga Boonga",93000,113000,20000,1.99,21.51,75,0.49
"2197",2197,"KAMI",104000,113000,9000,3.99,8.65,50,1.99
"2198",2198,"PRO EVOLUTION SOCCER 2019",0,113000,113000,59.99,0,50,29.99
"2199",2199,"Fort Defense",92000,113000,21000,4.99,22.83,90,0.49
"2200",2200,"House of Caravan",110000,113000,3000,4.99,2.73,90,0.49
"2201",2201,"UFO: Extraterrestrials Gold",108000,113000,5000,9.99,4.63,0,9.99
"2202",2202,"Resurgence",28000,112000,84000,0.99,300,0,0.99
"2203",2203,"Cloudbuilt",90000,112000,22000,19.99,24.44,75,4.99
"2204",2204,"Enigmatis 2: The Mists of Ravenwood",107000,112000,5000,9.99,4.67,60,3.99
"2205",2205,"Finding Teddy",109000,112000,3000,6.99,2.75,80,1.39
"2206",2206,"Avernum: Escape From the Pit",109000,112000,3000,9.99,2.75,70,2.99
"2207",2207,"Technobabylon",86000,112000,26000,14.99,30.23,75,3.74
"2208",2208,"Cossacks: European Wars",88000,112000,24000,4.99,27.27,75,1.24
"2209",2209,"Platformines",107000,111000,4000,9.99,3.74,70,2.99
"2210",2210,"Waves",103000,111000,8000,4.99,7.77,80,0.99
"2211",2211,"Neon Space 2",98000,111000,13000,4.99,13.27,90,0.49
"2212",2212,"The Escapists: The Walking Dead",108000,111000,3000,17.99,2.78,75,4.49
"2213",2213,"Ylands",88000,111000,23000,15,26.14,20,12
"2214",2214,"Agents of Mayhem",75000,111000,36000,29.99,48,75,7.49
"2215",2215,"Ultimate General: Civil War",1e+05,111000,11000,29.99,11,70,8.99
"2216",2216,"Angvik",91000,111000,20000,2.99,21.98,25,2.24
"2217",2217,"DESOLATE",74000,110000,36000,19.99,48.65,35,12.99
"2218",2218,"Silent Hill Homecoming",98000,110000,12000,39.99,12.24,85,5.99
"2219",2219,"Hello Neighbor",81000,110000,29000,29.99,35.8,50,14.99
"2220",2220,"Hamilton's Great Adventure",94000,110000,16000,9.99,17.02,75,2.49
"2221",2221,"Deadlight: Director's Cut",103000,110000,7000,11.99,6.8,75,2.99
"2222",2222,"METAL GEAR SURVIVE",77000,110000,33000,29.99,42.86,50,14.99
"2223",2223,"Burst",107000,110000,3000,1.99,2.8,75,0.49
"2224",2224,"Knights of Pen and Paper 2",95000,110000,15000,7.99,15.79,75,1.99
"2225",2225,"CortexGear: AngryDroids",52000,110000,58000,5.99,111.54,60,2.39
"2226",2226,"Fake Colours",86000,110000,24000,2.99,27.91,83,0.5
"2227",2227,"Silence of the Sleep",104000,110000,6000,4.99,5.77,90,0.49
"2228",2228,"35MM",98000,110000,12000,8.99,12.24,80,1.79
"2229",2229,"HELLION",37000,110000,73000,24.99,197.3,40,14.99
"2230",2230,"Convoy",78000,109000,31000,14.99,39.74,75,3.74
"2231",2231,"Tales from Candlekeep: Tomb of Annihilation",79000,109000,30000,15.99,37.97,60,6.39
"2232",2232,"Post Master",97000,109000,12000,4.99,12.37,80,0.99
"2233",2233,"The Path",107000,109000,2000,9.99,1.87,66,3.39
"2234",2234,"Sonic Forces",55000,109000,54000,39.99,98.18,75,9.99
"2235",2235,"Zuma's Revenge!",104000,109000,5000,4.99,4.81,75,1.24
"2236",2236,"Grimind",101000,109000,8000,9.99,7.92,90,0.99
"2237",2237,"Escape Rosecliff Island",106000,109000,3000,4.99,2.83,75,1.24
"2238",2238,"Ancient Planet Tower Defense",92000,109000,17000,4.99,18.48,66,1.69
"2239",2239,"Otaku's Fantasy",99000,109000,10000,1.99,10.1,70,0.59
"2240",2240,"新仙剑奇侠传 单机版(Chinese Paladin：Sword and Fairy)",71000,108000,37000,4.99,52.11,32,3.39
"2241",2241,"Cat on a Diet",98000,108000,10000,4.99,10.2,90,0.49
"2242",2242,"Insecticide Part 1",91000,108000,17000,0.99,18.68,75,0.49
"2243",2243,"Fly'N",105000,108000,3000,9.99,2.86,90,1.39
"2244",2244,"Unity of Command: Stalingrad Campaign",106000,108000,2000,19.99,1.89,85,2.99
"2245",2245,"The Detail",70000,108000,38000,2.99,54.29,80,0.74
"2246",2246,"American Conquest: Fight Back",62000,108000,46000,4.99,74.19,75,1.24
"2247",2247,"UnderRail",98000,108000,10000,14.99,10.2,60,5.99
"2248",2248,"Saku Saku: Love Blooms with the Cherry Blossoms",72000,108000,36000,19.99,50,50,9.99
"2249",2249,"Ben and Ed",97000,107000,10000,9.99,10.31,60,3.99
"2250",2250,"King Exit",87000,107000,20000,1.99,22.99,70,0.59
"2251",2251,"Colony Survival",91000,107000,16000,19.99,17.58,25,14.99
"2252",2252,"Candy Blast",74000,107000,33000,0.99,44.59,30,0.69
"2253",2253,"The Universim",14000,107000,93000,29.99,664.29,20,23.99
"2254",2254,"Dispatcher",35000,107000,72000,4.99,205.71,90,0.49
"2255",2255,"TrackMania² Valley",103000,107000,4000,19.99,3.88,70,5.99
"2256",2256,"Lexica",92000,107000,15000,4.99,16.3,80,0.99
"2257",2257,"Naval Action",102000,107000,5000,39.99,4.9,60,15.99
"2258",2258,"BlazBlue Centralfiction",80000,107000,27000,39.99,33.75,75,9.99
"2259",2259,"Cultist Simulator",49000,107000,58000,19.99,118.37,25,14.99
"2260",2260,"Fairyland: Incursion",84000,106000,22000,4.99,26.19,90,0.49
"2261",2261,"Pongo",71000,106000,35000,0.99,49.3,51,0.49
"2262",2262,"Master of Orion 3",104000,106000,2000,9.99,1.92,75,2.49
"2263",2263,"The Magic Circle",101000,106000,5000,19.99,4.95,75,4.99
"2264",2264,"Grass Cutter",68000,106000,38000,4.99,55.88,75,0.54
"2265",2265,"Randal's Monday",95000,106000,11000,19.99,11.58,90,2.99
"2266",2266,"Project:surviving",92000,106000,14000,0.99,15.22,75,0.49
"2267",2267,"Crimson Earth 2",41000,106000,65000,0.99,158.54,51,0.49
"2268",2268,"Opus Magnum",69000,106000,37000,19.99,53.62,50,9.99
"2269",2269,"Reveal The Deep",102000,106000,4000,0.99,3.92,51,0.49
"2270",2270,"Full Throttle Remastered",86000,106000,20000,14.99,23.26,50,7.49
"2271",2271,"1953 - KGB Unleashed",102000,106000,4000,5.99,3.92,70,1.79
"2272",2272,"Lilly Looking Through",1e+05,106000,6000,9.99,6,90,0.99
"2273",2273,"Dead Effect 2",77000,106000,29000,11.99,37.66,80,2.39
"2274",2274,"realMyst: Masterpiece Edition",99000,106000,7000,17.99,7.07,65,6.29
"2275",2275,"Elegy for a Dead World",77000,106000,29000,14.99,37.66,76,3.59
"2276",2276,"The Legend of Heroes: Trails of Cold Steel",84000,106000,22000,39.99,26.19,40,23.99
"2277",2277,"Biodrone Battle",82000,106000,24000,1.99,29.27,75,0.49
"2278",2278,"Weapon Shop Fantasy",62000,106000,44000,6.99,70.97,50,3.49
"2279",2279,"Portal of Evil: Stolen Runes Collector's Edition",76000,106000,30000,4.99,39.47,90,0.49
"2280",2280,"Mist Survival",0,106000,106000,10.99,0,10,9.89
"2281",2281,"Dark Matter",78000,106000,28000,4.99,35.9,80,0.99
"2282",2282,"Age of Civilizations II",0,105000,105000,4.99,0,0,4.99
"2283",2283,"One Star",82000,105000,23000,2.99,28.05,83,0.5
"2284",2284,"Ghost of a Tale",67000,105000,38000,24.99,56.72,20,19.99
"2285",2285,"Random Access Murder",101000,105000,4000,0.99,3.96,83,0.5
"2286",2286,"Darkstar One",98000,105000,7000,9.99,7.14,90,0.99
"2287",2287,"Hentai Puzzle",59000,105000,46000,0.99,77.97,51,0.49
"2288",2288,"Cultures - Northland",91000,105000,14000,4.99,15.38,90,0.49
"2289",2289,"Final Dusk",88000,105000,17000,2.99,19.32,83,0.5
"2290",2290,"Street Fighter IV",1e+05,105000,5000,19.99,5,0,19.99
"2291",2291,"1,000 Heads Among the Trees",71000,105000,34000,6.99,47.89,90,0.69
"2292",2292,"Immortal Redneck",38000,105000,67000,19.95,176.32,66,6.78
"2293",2293,"The Gleam: VR Escape the Room",9000,105000,96000,3.99,1066.67,55,1.79
"2294",2294,"Tannenberg",60000,105000,45000,19.99,75,50,9.99
"2295",2295,"CT Special Forces: Fire for Effect",102000,105000,3000,2.99,2.94,70,0.89
"2296",2296,"Blaster Shooter GunGuy!",96000,105000,9000,1.99,9.38,25,1.49
"2297",2297,"Bizarre Earthquake",94000,105000,11000,1.99,11.7,75,0.49
"2298",2298,"Village Story",101000,105000,4000,1.99,3.96,75,0.49
"2299",2299,"ESports Club / 电竞俱乐部",25000,104000,79000,8.99,316,25,6.74
"2300",2300,"Dead Horde",98000,104000,6000,5.99,6.12,75,1.49
"2301",2301,"Rusty Lake: Roots",87000,104000,17000,2.99,19.54,50,1.49
"2302",2302,"WILL: A Wonderful World / WILL：美好世界",77000,104000,27000,14.99,35.06,15,12.74
"2303",2303,"Pathologic Classic HD",90000,104000,14000,12.99,15.56,90,1.29
"2304",2304,"Hitman GO: Definitive Edition",83000,104000,21000,7.99,25.3,80,1.59
"2305",2305,"A Lenda do Herói - O Herói desta Canção",53000,104000,51000,15.99,96.23,0,15.99
"2306",2306,"You Must Build A Boat",73000,104000,31000,4.99,42.47,0,4.99
"2307",2307,"AKIBA'S TRIP: Undead ＆ Undressed",1e+05,104000,4000,29.99,4,50,14.99
"2308",2308,"Attack on Titan / A.O.T. Wings of Freedom",82000,104000,22000,59.99,26.83,50,29.99
"2309",2309,"Replica",1e+05,104000,4000,2.99,4,50,1.49
"2310",2310,"Mission: Escape from Island",42000,104000,62000,1.99,147.62,75,0.49
"2311",2311,"Fairyland: Fairy Power",73000,104000,31000,4.99,42.47,90,0.49
"2312",2312,"Abyss: The Wraiths of Eden",99000,103000,4000,9.99,4.04,70,2.99
"2313",2313,"Scrap Garden",88000,103000,15000,9.99,17.05,85,1.49
"2314",2314,"fault - milestone two side:above",56000,103000,47000,14.99,83.93,50,7.49
"2315",2315,"Chime",84000,103000,19000,4.99,22.62,80,0.99
"2316",2316,"Drakensang",95000,103000,8000,9.99,8.42,75,2.49
"2317",2317,"King's Quest Collection",91000,103000,12000,19.99,13.19,33,13.39
"2318",2318,"Defence to death",78000,103000,25000,1.99,32.05,75,0.49
"2319",2319,"The Last Door - Collector's Edition",94000,103000,9000,9.99,9.57,75,2.49
"2320",2320,"White Noise 2",62000,103000,41000,9.99,66.13,65,3.49
"2321",2321,"Serial Cleaner",17000,102000,85000,14.99,500,70,4.49
"2322",2322,"Syberia 3",83000,102000,19000,29.99,22.89,60,11.99
"2323",2323,"Zombie Training Simulator",66000,102000,36000,19.99,54.55,50,9.99
"2324",2324,"Puzzle Kingdoms",1e+05,102000,2000,14.99,2,90,1.49
"2325",2325,"CAT Interstellar",88000,102000,14000,4.99,15.91,60,1.99
"2326",2326,"Infinitum",86000,102000,16000,4.99,18.6,90,0.49
"2327",2327,"Emily Wants To Play",96000,102000,6000,4.99,6.25,51,2.44
"2328",2328,"Death to Spies: Moment of Truth",93000,102000,9000,6.99,9.68,80,1.39
"2329",2329,"Higurashi When They Cry Hou - Ch.1 Onikakushi",84000,102000,18000,5.99,21.43,75,1.49
"2330",2330,"TIMEframe",97000,102000,5000,5.99,5.15,80,1.59
"2331",2331,"Clone Drone in the Danger Zone",72000,102000,30000,14.99,41.67,34,9.89
"2332",2332,"Sherlock Holmes - Nemesis",93000,102000,9000,9.99,9.68,75,2.49
"2333",2333,"Chicken Labyrinth Puzzles",58000,101000,43000,0.99,74.14,51,0.49
"2334",2334,"Tom Clancy's Ghost Recon Desert Siege",76000,101000,25000,4.99,32.89,66,1.69
"2335",2335,"Fox Hime",80000,101000,21000,1.99,26.25,60,0.79
"2336",2336,"Kung Fury: Street Rage",93000,101000,8000,2.99,8.6,50,1.49
"2337",2337,"BlazeRush",97000,101000,4000,9.99,4.12,75,2.49
"2338",2338,"Costume Quest 2",87000,101000,14000,14.99,16.09,85,2.24
"2339",2339,"AuroraRL",15000,101000,86000,4.99,573.33,90,0.49
"2340",2340,"天命奇御 Fate Seeker",0,101000,101000,21.09,0,0,21.09
"2341",2341,"Dead Island Retro Revenge",87000,101000,14000,4.99,16.09,50,2.49
"2342",2342,"Rituals",91000,101000,10000,4.99,10.99,0,4.99
"2343",2343,"Russian Car Driver",82000,1e+05,18000,0.99,21.95,51,0.49
"2344",2344,"Heroes of Hammerwatch",59000,1e+05,41000,11.99,69.49,20,9.59
"2345",2345,"Meridian: New World",91000,1e+05,9000,6.99,9.89,80,1.39
"2346",2346,"Inner silence",76000,1e+05,24000,0.99,31.58,51,0.49
"2347",2347,"Syrian Warfare",48000,1e+05,52000,13.99,108.33,67,4.94
"2348",2348,"Hooligan Vasja",95000,1e+05,5000,0.99,5.26,51,0.49
"2349",2349,"8-Bit Armies",91000,1e+05,9000,14.99,9.89,52,7.19
"2350",2350,"rFactor 2",64000,1e+05,36000,31.99,56.25,50,15.99
"2351",2351,"The Technomancer",82000,1e+05,18000,29.99,21.95,75,7.49
"2352",2352,"Killing Room",57000,1e+05,43000,9.99,75.44,60,3.99
"2353",2353,"Nightmares from the Deep 3: Davy Jones",65000,1e+05,35000,9.99,53.85,70,2.99
"2354",2354,"Silent Hunter 5: Battle of the Atlantic",92000,1e+05,8000,9.99,8.7,66,3.39
"2355",2355,"Duke of Alpha Centauri",80000,1e+05,20000,4.99,25,90,0.49
"2356",2356,"Fernbus Simulator",86000,99000,13000,34.99,15.12,55,15.74
"2357",2357,"Steam Heroes",87000,99000,12000,5.99,13.79,90,0.59
"2358",2358,"Great Hero's Beard",0,99000,99000,1.99,0,50,0.99
"2359",2359,"The End Is Nigh",62000,99000,37000,14.99,59.68,60,5.99
"2360",2360,"Gloria Victis",77000,99000,22000,19.99,28.57,60,7.99
"2361",2361,"Orwell: Ignorance is Strength",38000,99000,61000,9.99,160.53,40,5.99
"2362",2362,"CrazyCars3D",51000,99000,48000,2.99,94.12,50,1.49
"2363",2363,"Killbot",76000,99000,23000,0.99,30.26,0,0.99
"2364",2364,"Shantae: Half-Genie Hero",72000,99000,27000,19.99,37.5,25,14.99
"2365",2365,"SENRAN KAGURA SHINOVI VERSUS",91000,99000,8000,29.99,8.79,50,14.99
"2366",2366,"Fortix 2",77000,99000,22000,1.99,28.57,0,1.99
"2367",2367,"Bloodsports.TV",77000,99000,22000,9.99,28.57,75,2.49
"2368",2368,"realMYST",97000,99000,2000,5.99,2.06,0,5.99
"2369",2369,"Pinball FX3",25000,99000,74000,23.97,296,255,9.57
"2370",2370,"Nightmares from the Deep 2: The Siren`s Call",95000,99000,4000,9.99,4.21,70,2.99
"2371",2371,"Wildlife Park 2",94000,98000,4000,6.99,4.26,33,4.68
"2372",2372,"Tom Clancy's EndWar",92000,98000,6000,9.99,6.52,66,3.39
"2373",2373,"Magic Box",69000,98000,29000,0.99,42.03,51,0.49
"2374",2374,"FINAL FANTASY V",79000,98000,19000,15.99,24.05,50,7.99
"2375",2375,"Mutant Mudds Deluxe",89000,98000,9000,9.99,10.11,90,0.99
"2376",2376,"To The Capital",55000,98000,43000,1.99,78.18,55,0.89
"2377",2377,"Lume",96000,98000,2000,5.99,2.08,60,2.39
"2378",2378,"Wizardry 7: Crusaders of the Dark Savant",89000,98000,9000,4.99,10.11,80,0.99
"2379",2379,"Shattered Planet",96000,98000,2000,14.99,2.08,85,2.24
"2380",2380,"Vanishing Realms",88000,98000,10000,19.99,11.36,35,12.99
"2381",2381,"A Game of Dwarves",87000,98000,11000,9.99,12.64,80,1.99
"2382",2382,"Raw Data",92000,98000,6000,39.99,6.52,60,15.99
"2383",2383,"Flight of the Paladin",90000,98000,8000,1.99,8.89,75,0.49
"2384",2384,"Darksiders III",0,98000,98000,59.99,0,0,59.99
"2385",2385,"DARK",91000,98000,7000,9.99,7.69,90,0.99
"2386",2386,"Borderless Gaming",87000,98000,11000,3.99,12.64,65,1.39
"2387",2387,"Tom Clancy's Rainbow Six Lockdown",65000,98000,33000,9.99,50.77,66,3.39
"2388",2388,"Super Trench Attack!",93000,97000,4000,4.99,4.3,90,0.49
"2389",2389,"Void Destroyer",93000,97000,4000,9.99,4.3,80,1.99
"2390",2390,"Dinosaur Forest",72000,96000,24000,1.99,33.33,75,0.49
"2391",2391,"Blackwell Deception",94000,96000,2000,9.99,2.13,80,1.99
"2392",2392,"FINAL FANTASY XII THE ZODIAC AGE",64000,96000,32000,49.99,50,50,24.99
"2393",2393,"永遠消失的幻想鄉 ～ The Disappearing of Gensokyo",46000,96000,50000,10.99,108.7,30,7.69
"2394",2394,"Elven Legacy",89000,96000,7000,4.99,7.87,80,0.99
"2395",2395,"Sherlock Holmes: The Silver Earring",60000,96000,36000,9.99,60,80,1.99
"2396",2396,"Yonder: The Cloud Catcher Chronicles",67000,96000,29000,24.99,43.28,45,13.74
"2397",2397,"POPixel",78000,96000,18000,0.99,23.08,0,0.99
"2398",2398,"Dusty Revenge:Co-Op Edition",94000,96000,2000,14.99,2.13,80,2.99
"2399",2399,"Death to Spies",93000,96000,3000,4.99,3.23,80,0.99
"2400",2400,"Doorways: Prelude",84000,96000,12000,9.99,14.29,80,1.99
"2401",2401,"Super Mega Baseball: Extra Innings",90000,96000,6000,19.99,6.67,80,3.99
"2402",2402,"Crimson Earth",67000,96000,29000,0.99,43.28,51,0.49
"2403",2403,"Assault Android Cactus",94000,96000,2000,14.99,2.13,60,5.99
"2404",2404,"Secret Files: Tunguska",81000,96000,15000,9.99,18.52,75,2.49
"2405",2405,"City Car Driving",75000,96000,21000,24.99,28,25,18.74
"2406",2406,"DubWars",65000,96000,31000,9.99,47.69,90,0.99
"2407",2407,"Tom Clancy's Ghost Recon Island Thunder",92000,96000,4000,4.99,4.35,66,1.69
"2408",2408,"Slain: Back from Hell",70000,96000,26000,12.99,37.14,80,2.59
"2409",2409,"The Yawhg",81000,95000,14000,9.99,17.28,60,3.99
"2410",2410,"Mutiny!!",54000,95000,41000,9.99,75.93,25,7.49
"2411",2411,"Cube Runner",91000,95000,4000,4.99,4.4,90,0.49
"2412",2412,"Deep Space Waifu: FLAT JUSTICE",70000,95000,25000,1.99,35.71,30,1.39
"2413",2413,"Starion Tactics",73000,95000,22000,9.99,30.14,0,9.99
"2414",2414,"Half Minute Hero: The Second Coming",82000,95000,13000,9.99,15.85,75,2.49
"2415",2415,"The 7th Guest",83000,95000,12000,5.99,14.46,80,1.19
"2416",2416,"Charlie's Adventure",88000,95000,7000,4.99,7.95,90,0.49
"2417",2417,"Angels of Fasaria: Version 2.0",92000,95000,3000,4.99,3.26,80,0.99
"2418",2418,"ReignMaker",53000,95000,42000,14.99,79.25,50,7.49
"2419",2419,"Chernobyl Commando",90000,95000,5000,9.99,5.56,90,0.99
"2420",2420,"Fate/EXTELLA",68000,94000,26000,49.99,38.24,40,29.99
"2421",2421,"Zup! Zero",89000,94000,5000,0.99,5.62,30,0.69
"2422",2422,"Trials 2: Second Edition",91000,94000,3000,9.99,3.3,0,9.99
"2423",2423,"Salt",76000,94000,18000,14.99,23.68,75,3.74
"2424",2424,"Hue",84000,94000,10000,14.99,11.9,75,3.74
"2425",2425,"Zuma Deluxe",83000,94000,11000,4.99,13.25,75,1.24
"2426",2426,"Breach & Clear: Deadline Rebirth (2016)",79000,94000,15000,9.99,18.99,90,0.99
"2427",2427,"The Quest for Achievements",77000,94000,17000,4.99,22.08,80,0.99
"2428",2428,"Elise the Devil",76000,93000,17000,1.99,22.37,70,0.59
"2429",2429,"Rusty Lake Hotel",81000,93000,12000,1.99,14.81,50,0.99
"2430",2430,"Niche - a genetics survival game",72000,93000,21000,17.99,29.17,40,10.79
"2431",2431,"Tengami",65000,93000,28000,4.99,43.08,15,4.24
"2432",2432,"Cultures - 8th Wonder of the World",84000,93000,9000,4.99,10.71,90,0.49
"2433",2433,"Foul Play",91000,93000,2000,14.99,2.2,75,3.74
"2434",2434,"Slash It",90000,93000,3000,4.99,3.33,90,0.49
"2435",2435,"Aura: Fate of the Ages",49000,92000,43000,4.99,87.76,75,1.24
"2436",2436,"WWE 2K18",46000,92000,46000,59.99,100,75,14.99
"2437",2437,"Desert Thunder",88000,92000,4000,2.99,4.55,70,0.89
"2438",2438,"Call to 10",90000,92000,2000,1.99,2.22,60,0.79
"2439",2439,"Time Mysteries 2: The Ancient Spectres",85000,92000,7000,9.99,8.24,70,2.99
"2440",2440,"Western Press",71000,92000,21000,4.99,29.58,75,1.24
"2441",2441,"Sirius",69000,92000,23000,4.99,33.33,0,4.99
"2442",2442,"Cognition: An Erica Reed Thriller",83000,92000,9000,14.99,10.84,75,3.74
"2443",2443,"The Age of Decadence",79000,92000,13000,19.99,16.46,75,4.99
"2444",2444,"Burn Zombie Burn!",87000,92000,5000,9.99,5.75,0,9.99
"2445",2445,"Island Defense",80000,92000,12000,1.99,15,0,1.99
"2446",2446,"SteamWorld Dig 2",44000,92000,48000,19.99,109.09,50,9.99
"2447",2447,"The Adventures of Tree",86000,92000,6000,4.99,6.98,80,0.99
"2448",2448,"Summoner",82000,92000,10000,4.99,12.2,75,1.24
"2449",2449,"Project: Snowblind",81000,91000,10000,5.99,12.35,85,0.89
"2450",2450,"Sudden Strike 4",70000,91000,21000,49.99,30,75,12.5
"2451",2451,"Master Spy",63000,91000,28000,9.99,44.44,90,0.99
"2452",2452,"Cossacks: Art of War",53000,91000,38000,4.99,71.7,75,1.24
"2453",2453,"LEGO Pirates of the Caribbean: The Video Game",87000,91000,4000,19.99,4.6,65,6.99
"2454",2454,"Project: R.E.B.O.O.T",63000,91000,28000,0.99,44.44,51,0.49
"2455",2455,"The Masterplan",61000,91000,30000,19.99,49.18,80,3.99
"2456",2456,"Yet Another Zombie Defense HD",73000,91000,18000,3.99,24.66,75,0.99
"2457",2457,"D4: Dark Dreams Don’t Die -Season One-",69000,91000,22000,14.99,31.88,70,4.49
"2458",2458,"Realms of Arkania: Blade of Destiny",87000,91000,4000,14.99,4.6,66,5.09
"2459",2459,"Xotic",80000,91000,11000,9.99,13.75,0,9.99
"2460",2460,"Stellar Impact",84000,91000,7000,9.99,8.33,0,9.99
"2461",2461,"Black Mirror II",86000,91000,5000,9.99,5.81,75,2.49
"2462",2462,"Parkitect",49000,91000,42000,29.99,85.71,0,19.99
"2463",2463,"Star Trek: Bridge Crew",70000,91000,21000,39.99,30,50,19.99
"2464",2464,"theBlu",89000,91000,2000,9.99,2.25,30,6.99
"2465",2465,"Axis Football 2015",85000,91000,6000,4.99,7.06,10,4.49
"2466",2466,"Armored Gear",88000,91000,3000,2.99,3.41,83,0.5
"2467",2467,"The Big Elk",77000,90000,13000,4.99,16.88,90,0.49
"2468",2468,"Green Cat",48000,90000,42000,2.99,87.5,83,0.5
"2469",2469,"Beastiarium",62000,90000,28000,14.99,45.16,80,2.99
"2470",2470,"Noct",75000,90000,15000,9.99,20,90,0.99
"2471",2471,"The Chaos Engine",86000,90000,4000,9.99,4.65,0,9.99
"2472",2472,"Amnesia: Memories",64000,89000,25000,19.99,39.06,90,2.99
"2473",2473,"Carmageddon Max Pack",82000,89000,7000,9.99,8.54,75,2.49
"2474",2474,"Flight Control HD",87000,89000,2000,4.99,2.3,75,1.24
"2475",2475,"Iron Front: Digital War Edition",84000,89000,5000,14.99,5.95,75,3.74
"2476",2476,"Cibele",85000,89000,4000,8.99,4.71,50,4.49
"2477",2477,"Ultratron",85000,89000,4000,9.99,4.71,63,3.69
"2478",2478,"Luna's Wandering Stars",41000,89000,48000,9.99,117.07,90,0.99
"2479",2479,"All Alone: VR",86000,89000,3000,3.99,3.49,87,0.51
"2480",2480,"STARS Simulation",49000,89000,40000,0.99,81.63,0,0.99
"2481",2481,"The 11th Hour",75000,89000,14000,5.99,18.67,80,1.19
"2482",2482,"Glass Wing",71000,88000,17000,5.99,23.94,85,0.89
"2483",2483,"QUBIC",53000,88000,35000,2.99,66.04,84,0.49
"2484",2484,"GUILTY GEAR Xrd -REVELATOR-",75000,88000,13000,29.99,17.33,67,9.89
"2485",2485,"Fragmented",84000,88000,4000,9.99,4.76,86,1.39
"2486",2486,"Crystal City",62000,88000,26000,5.99,41.94,90,0.59
"2487",2487,"Foreign Legion: Buckets of Blood",85000,88000,3000,4.99,3.53,90,0.49
"2488",2488,"Envy the Dead",86000,88000,2000,0.99,2.33,51,0.49
"2489",2489,"Team Indie",85000,88000,3000,12.99,3.53,90,1.29
"2490",2490,"Upside Down",69000,88000,19000,4.99,27.54,90,0.49
"2491",2491,"aMAZE",86000,88000,2000,0.99,2.33,51,0.49
"2492",2492,"Zup! 5",81000,88000,7000,0.99,8.64,30,0.69
"2493",2493,"SimAirport",75000,88000,13000,19.99,17.33,30,13.99
"2494",2494,"Mini Motor Racing EVO",86000,88000,2000,4.99,2.33,75,1.24
"2495",2495,"GUN",77000,88000,11000,19.99,14.29,75,4.99
"2496",2496,"Anomaly Defenders",58000,88000,30000,9.99,51.72,85,1.49
"2497",2497,"Worms World Party Remastered",66000,88000,22000,14.99,33.33,80,2.99
"2498",2498,"Dark Sector",78000,88000,10000,9.99,12.82,0,9.99
"2499",2499,"Danganronpa V3: Killing Harmony",54000,88000,34000,59.99,62.96,50,29.99
"2500",2500,"Sunrider Academy",80000,88000,8000,9.99,10,75,2.49
"2501",2501,"Grand Ages: Medieval",77000,88000,11000,19.99,14.29,80,3.99
"2502",2502,"IL-2 Sturmovik: Battle of Stalingrad",71000,88000,17000,49.99,23.94,66,16.99
"2503",2503,"About Love, Hate and the other ones",67000,87000,20000,6.99,29.85,90,0.69
"2504",2504,"Who's your Santa !?",74000,87000,13000,3.99,17.57,35,1.94
"2505",2505,"Droid Assault",81000,87000,6000,9.99,7.41,63,3.69
"2506",2506,"Train Sim World",67000,87000,20000,52,29.85,77,9.19
"2507",2507,"Project of the Developer",85000,87000,2000,0.99,2.35,49,0.5
"2508",2508,"Z Steel Soldiers",84000,87000,3000,12.99,3.57,90,1.29
"2509",2509,"Airships: Conquer the Skies",39000,87000,48000,14.99,123.08,20,11.99
"2510",2510,"It came from space, and ate our brains",65000,87000,22000,9.99,33.85,65,3.49
"2511",2511,"Virginia",66000,87000,21000,9.99,31.82,90,0.99
"2512",2512,"Parkan 2",81000,87000,6000,3.99,7.41,75,0.99
"2513",2513,"Wooden Floor",85000,87000,2000,1.99,2.35,50,0.99
"2514",2514,"Aurion: Legacy of the Kori-Odan",78000,87000,9000,14.99,11.54,50,7.49
"2515",2515,"GOD's DEATH",68000,87000,19000,3.99,27.94,80,0.79
"2516",2516,"Impossible Creatures Steam Edition",83000,86000,3000,9.99,3.61,75,2.49
"2517",2517,"Ultimate Word Search 2: Letter Boxed",38000,86000,48000,0.99,126.32,75,0.49
"2518",2518,"GTR 2 FIA GT Racing Game",80000,86000,6000,7.99,7.5,50,3.99
"2519",2519,"LEGO City Undercover",50000,86000,36000,39.99,72,75,9.99
"2520",2520,"ARCADE GAME SERIES: GALAGA",79000,86000,7000,3.99,8.86,50,1.99
"2521",2521,"Warhammer Quest",83000,86000,3000,14.99,3.61,80,2.99
"2522",2522,"H.I.S.T.O.R.Y T.O.R.C.H.K.A",65000,86000,21000,0.99,32.31,51,0.49
"2523",2523,"Theatre of War 2: Kursk 1943",81000,86000,5000,4.99,6.17,80,0.99
"2524",2524,"Unmechanical",83000,86000,3000,9.99,3.61,75,2.49
"2525",2525,"Castle Werewolf 3D",75000,86000,11000,2.99,14.67,83,0.5
"2526",2526,"Our End of the World",61000,86000,25000,9.99,40.98,20,7.99
"2527",2527,"Airport CEO",64000,86000,22000,15.99,34.38,30,11.19
"2528",2528,"Score a goal (Physical football)",78000,86000,8000,9.99,10.26,90,0.99
"2529",2529,"Miner Wars 2081",75000,86000,11000,9.99,14.67,60,3.99
"2530",2530,"The Magical Silence",82000,86000,4000,0.99,4.88,51,0.49
"2531",2531,"Dino Run DX",46000,86000,40000,5.99,86.96,80,1.19
"2532",2532,"The Book of Unwritten Tales 2",73000,86000,13000,29.99,17.81,75,7.49
"2533",2533,"Out of Reach",68000,86000,18000,14.99,26.47,50,7.49
"2534",2534,"Machine Hunt",79000,86000,7000,2.99,8.86,84,0.49
"2535",2535,"Lunar Flight",80000,86000,6000,14.99,7.5,75,3.74
"2536",2536,"Time Mysteries 3: The Final Enigma",79000,85000,6000,9.99,7.59,70,2.99
"2537",2537,"Ultimate Arena",71000,85000,14000,4.99,19.72,80,0.59
"2538",2538,"Legion TD 2",66000,85000,19000,19.99,28.79,55,8.99
"2539",2539,"Forgotten Heroes",80000,85000,5000,0.99,6.25,51,0.49
"2540",2540,"Shift",76000,85000,9000,0.99,11.84,51,0.49
"2541",2541,"Death Rally",83000,85000,2000,9.99,2.41,80,1.99
"2542",2542,"Black Mirror III",72000,85000,13000,9.99,18.06,75,2.49
"2543",2543,"Euro Fishing",82000,85000,3000,19.99,3.66,75,4.99
"2544",2544,"Guns, Gore & Cannoli",59000,85000,26000,9.99,44.07,50,4.99
"2545",2545,"Street Legal Racing: Redline v2.3.1",71000,85000,14000,5.99,19.72,30,3.99
"2546",2546,"Damnation",81000,85000,4000,9.99,4.94,80,1.99
"2547",2547,"Pix the Cat",81000,85000,4000,9.99,4.94,85,1.49
"2548",2548,"The God's Chain",78000,85000,7000,7.99,8.97,90,0.79
"2549",2549,"Earth Defense Force: Insect Armageddon",82000,85000,3000,9.99,3.66,0,9.99
"2550",2550,"FreeCell Quest",66000,85000,19000,9.99,28.79,75,2.49
"2551",2551,"Pixel Heroes: Byte & Magic",81000,85000,4000,9.99,4.94,60,3.99
"2552",2552,"Faery - Legends of Avalon",80000,85000,5000,9.99,6.25,75,2.49
"2553",2553,"Cyberdimension Neptunia: 4 Goddesses Online | 四女神オンライン CYBER DIMENSION NEPTUNE | 四女神ONLINE 幻次元遊戲戰機少女",51000,85000,34000,39.99,66.67,60,15.99
"2554",2554,"1 Moment Of Time: Silentville",50000,85000,35000,0.99,70,51,0.49
"2555",2555,"Disc Jam",28000,85000,57000,14.99,203.57,75,3.74
"2556",2556,"Offensive Combat: Redux!",82000,85000,3000,14.99,3.66,50,7.49
"2557",2557,"Aviary Attorney",63000,85000,22000,14.99,34.92,75,3.74
"2558",2558,"Rusted Warfare - RTS",23000,84000,61000,4.99,265.22,42,2.89
"2559",2559,"Black The Fall",64000,84000,20000,14.99,31.25,50,7.49
"2560",2560,"King Arthur: Fallen Champions",79000,84000,5000,4.99,6.33,50,2.49
"2561",2561,"Puzzle Bots",78000,84000,6000,4.99,7.69,33,3.34
"2562",2562,"Endurance",68000,84000,16000,1.99,23.53,75,0.49
"2563",2563,"Mind Snares: Alice's Journey",76000,84000,8000,9.99,10.53,70,2.99
"2564",2564,"Retro/Grade",81000,84000,3000,9.99,3.7,75,2.49
"2565",2565,"iBomber Defense",81000,84000,3000,4.99,3.7,0,4.99
"2566",2566,"Green Hell",0,84000,84000,19.99,0,15,16.99
"2567",2567,"Nova-111",82000,84000,2000,4.99,2.44,75,2.24
"2568",2568,"Age of Wonders II: The Wizard's Throne",80000,84000,4000,9.99,5,75,2.49
"2569",2569,"Etherium",78000,84000,6000,9.99,7.69,80,1.99
"2570",2570,"Alien Shooter 2 Conscription",67000,84000,17000,9.99,25.37,65,3.49
"2571",2571,"Welcome to the Game",79000,84000,5000,4.99,6.33,66,1.69
"2572",2572,"A Kiss For The Petals - Remembering How We Met",64000,84000,20000,7.99,31.25,50,3.99
"2573",2573,"RISK: Factions",79000,84000,5000,9.99,6.33,80,1.99
"2574",2574,"Idol Magical Girl Chiru Chiru Michiru Part 1",79000,84000,5000,19.99,6.33,65,6.99
"2575",2575,"ZOMBI",69000,83000,14000,19.99,20.29,80,3.99
"2576",2576,"Magic Quest",58000,83000,25000,1.99,43.1,0,1.99
"2577",2577,"Eventide: Slavic Fable",58000,83000,25000,9.99,43.1,70,2.99
"2578",2578,"Rhythm Destruction",75000,83000,8000,4.99,10.67,80,0.99
"2579",2579,"Call of Duty: Black Ops - Mac Edition",53000,83000,30000,19.99,56.6,50,9.99
"2580",2580,"Fate of the World",79000,83000,4000,9.99,5.06,50,4.99
"2581",2581,"Book of Demons",36000,83000,47000,24.99,130.56,50,9.99
"2582",2582,"Snake Pass",65000,83000,18000,19.99,27.69,60,7.99
"2583",2583,"Zombie Night Terror",56000,83000,27000,12.99,48.21,85,1.94
"2584",2584,"THOTH",79000,83000,4000,4.99,5.06,80,0.99
"2585",2585,"Farming Simulator 2011",80000,83000,3000,9.99,3.75,50,4.99
"2586",2586,"Port Royale 2",77000,83000,6000,4.99,7.79,80,0.99
"2587",2587,"Fantasy Wars",80000,83000,3000,4.99,3.75,80,0.99
"2588",2588,"Wild Island Quest",78000,83000,5000,1.99,6.41,75,0.49
"2589",2589,"Endless Room",77000,83000,6000,1.99,7.79,0,1.99
"2590",2590,"Mindless Running",70000,83000,13000,0.99,18.57,51,0.49
"2591",2591,"Woolfe - The Red Hood Diaries",67000,83000,16000,9.99,23.88,66,3.39
"2592",2592,"Jets'n'Guns Gold",77000,83000,6000,6.99,7.79,75,1.74
"2593",2593,"汉匈决战/Han Xiongnu Wars",38000,82000,44000,11.99,115.79,35,7.79
"2594",2594,"Fruit Sudoku",69000,82000,13000,0.99,18.84,51,0.49
"2595",2595,"Master Reboot",79000,82000,3000,14.99,3.8,70,4.49
"2596",2596,"Fighter of Evil",79000,82000,3000,1.99,3.8,75,0.49
"2597",2597,"Paper Sorcerer",79000,82000,3000,4.99,3.8,80,0.99
"2598",2598,"Fly and Destroy",71000,82000,11000,4.99,15.49,90,0.49
"2599",2599,"Dead Synchronicity: Tomorrow Comes Today",70000,82000,12000,9.99,17.14,75,2.49
"2600",2600,"CASE: Animatronics",53000,82000,29000,9.99,54.72,90,0.99
"2601",2601,"Gurumin: A Monstrous Adventure",71000,82000,11000,9.99,15.49,65,3.49
"2602",2602,"Breathedge",0,82000,82000,15.99,0,25,11.99
"2603",2603,"Kopanito All-Stars Soccer",71000,82000,11000,5.99,15.49,50,2.99
"2604",2604,"Knytt Underground",78000,82000,4000,6.99,5.13,80,1.39
"2605",2605,"Pharaoh + Cleopatra",71000,82000,11000,9.99,15.49,50,4.99
"2606",2606,"Commander: Conquest of the Americas",77000,82000,5000,9.99,6.49,0,9.99
"2607",2607,"Merlin adventurer store",38000,82000,44000,2.99,115.79,50,1.49
"2608",2608,"Rogue Warrior",75000,82000,7000,4.99,9.33,75,1.24
"2609",2609,"Zero Escape: Zero Time Dilemma",39000,82000,43000,39.99,110.26,50,19.99
"2610",2610,"Penarium",64000,81000,17000,9.99,26.56,75,2.49
"2611",2611,"Crisis in the Kremlin",28000,81000,53000,4.99,189.29,60,1.99
"2612",2612,"Razortron 2000",72000,81000,9000,0.99,12.5,90,0.49
"2613",2613,"Japanese School Life",74000,81000,7000,9.99,9.46,60,3.99
"2614",2614,"Bulb Boy",58000,81000,23000,8.99,39.66,83,1.52
"2615",2615,"Botology",71000,81000,10000,0.99,14.08,51,0.49
"2616",2616,"Aarklash: Legacy",67000,81000,14000,15.99,20.9,90,1.59
"2617",2617,"Project: R.E.B.O.O.T 2",71000,81000,10000,0.99,14.08,51,0.49
"2618",2618,"Pixel Painter",45000,81000,36000,0.99,80,51,0.49
"2619",2619,"""Glow Ball"" - The billiard puzzle game",77000,81000,4000,4.99,5.19,60,1.99
"2620",2620,"Circle Empires",0,81000,81000,7.99,0,25,5.99
"2621",2621,"Shiftlings",35000,81000,46000,14.99,131.43,35,9.74
"2622",2622,"Global Ops: Commando Libya",67000,81000,14000,4.99,20.9,80,0.99
"2623",2623,"Guilty Gear Isuka",73000,80000,7000,9.99,9.59,80,1.99
"2624",2624,"Magical Diary: Horse Hall",58000,80000,22000,14.99,37.93,66,5.09
"2625",2625,"Mad Driver",67000,80000,13000,0.99,19.4,51,0.49
"2626",2626,"Vengeance",67000,80000,13000,8.99,19.4,53,4.22
"2627",2627,"In Between",66000,80000,14000,11.99,21.21,60,4.79
"2628",2628,"Containment: The Zombie Puzzler",74000,80000,6000,4.99,8.11,0,4.99
"2629",2629,"Deep Blue 3D Maze",56000,80000,24000,2.99,42.86,80,0.59
"2630",2630,"Warlock 2: The Exiled",78000,80000,2000,19.99,2.56,75,4.99
"2631",2631,"Life is Feudal: MMO",64000,80000,16000,29.99,25,50,14.99
"2632",2632,"Defense of Egypt: Cleopatra Mission",65000,80000,15000,6.99,23.08,45,3.84
"2633",2633,"Blood Knights",73000,80000,7000,9.99,9.59,80,1.99
"2634",2634,"Stikbold! A Dodgeball Adventure",78000,80000,2000,9.99,2.56,50,4.99
"2635",2635,"Hate Plus",55000,80000,25000,9.99,45.45,90,0.99
"2636",2636,"Apartment of Love",21000,80000,59000,1.99,280.95,60,0.79
"2637",2637,"Urizen Shadows of the Cold Deluxe Frosty Edition",32000,80000,48000,1.99,150,50,1.49
"2638",2638,"Barony",57000,80000,23000,14.99,40.35,85,2.24
"2639",2639,"UFO: Aftermath",71000,79000,8000,3.99,11.27,80,0.79
"2640",2640,"Out of the Park Baseball 19",13000,79000,66000,19.99,507.69,75,9.99
"2641",2641,".hack//G.U. Last Recode",37000,79000,42000,49.99,113.51,70,14.99
"2642",2642,"The Vagrant",31000,79000,48000,3.99,154.84,60,1.59
"2643",2643,"The Guild 3",40000,79000,39000,29.99,97.5,10,26.99
"2644",2644,"Feel The Snow",70000,79000,9000,8.99,12.86,40,5.39
"2645",2645,"Melty Blood Actress Again Current Code",65000,79000,14000,24.99,21.54,80,4.99
"2646",2646,"SENRAN KAGURA ESTIVAL VERSUS",65000,79000,14000,39.99,21.54,50,19.99
"2647",2647,"Zup! 6",59000,79000,20000,0.99,33.9,30,0.69
"2648",2648,"GIGANTIC ARMY",73000,79000,6000,5.99,8.22,50,2.99
"2649",2649,"Twin Sector",77000,79000,2000,4.99,2.6,75,1.24
"2650",2650,"Quest for Glory 1-5",62000,79000,17000,9.99,27.42,75,2.49
"2651",2651,"Marvel vs. Capcom: Infinite",65000,79000,14000,39.99,21.54,50,19.99
"2652",2652,"Sundered",41000,79000,38000,19.99,92.68,60,7.99
"2653",2653,"MY FIGHT",58000,79000,21000,3.99,36.21,66,1.35
"2654",2654,"Conflict: Denied Ops",67000,79000,12000,5.99,17.91,85,0.89
"2655",2655,"10 Second Ninja",68000,78000,10000,1.99,14.71,75,0.49
"2656",2656,"Rise of Venice",73000,78000,5000,19.99,6.85,80,3.99
"2657",2657,"Chronicles of a Dark Lord: Episode 1 Tides of Fate Complete",74000,78000,4000,1.99,5.41,62,0.75
"2658",2658,"Party of Sin",73000,78000,5000,5.99,6.85,50,2.99
"2659",2659,"MONOPOLY PLUS",46000,78000,32000,14.99,69.57,50,7.49
"2660",2660,"One More Dungeon",44000,78000,34000,4.99,77.27,66,1.69
"2661",2661,"Turok",75000,78000,3000,19.99,4,75,4.99
"2662",2662,"Battle Time",48000,78000,30000,0.99,62.5,51,0.49
"2663",2663,"Legends of Callasia",52000,78000,26000,14.99,50,75,3.74
"2664",2664,"POSTAL Redux",55000,77000,22000,8.99,40,85,1.34
"2665",2665,"Disgaea 2 PC / 魔界戦記ディスガイア2 PC",75000,77000,2000,19.99,2.67,60,7.99
"2666",2666,"A Wizard's Lizard",67000,77000,10000,9.99,14.93,75,2.49
"2667",2667,"Soulless: Ray Of Hope",50000,77000,27000,9.99,54,90,0.99
"2668",2668,"OlliOlli2: Welcome to Olliwood",43000,77000,34000,14.99,79.07,75,3.74
"2669",2669,"Loren The Amazon Princess",52000,77000,25000,19.99,48.08,75,4.99
"2670",2670,"Urban Empire",58000,77000,19000,29.99,32.76,80,5.99
"2671",2671,"Cold Waters",61000,77000,16000,39.99,26.23,30,27.99
"2672",2672,"Blood and Gold: Caribbean!",61000,77000,16000,19.99,26.23,80,3.99
"2673",2673,"Flight of the Icarus",74000,77000,3000,4.99,4.05,90,0.49
"2674",2674,"Draw Rider",62000,77000,15000,1.99,24.19,40,1.19
"2675",2675,"Puzzles Under The Hill",44000,77000,33000,0.99,75,80,0.49
"2676",2676,"Airline Tycoon Deluxe",73000,77000,4000,9.99,5.48,75,2.49
"2677",2677,"Rick and Morty: Virtual Rick-ality",61000,77000,16000,29.99,26.23,50,14.99
"2678",2678,"MAZE LORD",61000,76000,15000,4.99,24.59,90,0.49
"2679",2679,"Pacific Storm Allies",64000,76000,12000,7.99,18.75,90,0.79
"2680",2680,"eXceed - Gun Bullet Children",68000,76000,8000,2.99,11.76,50,1.49
"2681",2681,"BIGFOOT",61000,76000,15000,15.99,24.59,20,12.79
"2682",2682,"Industry Giant 2",67000,76000,9000,9.99,13.43,70,2.99
"2683",2683,"Ascension to the Throne",65000,76000,11000,2.99,16.92,77,0.68
"2684",2684,"Battle Group 2",71000,76000,5000,7.99,7.04,90,0.79
"2685",2685,"Tobe's Vertical Adventure",67000,76000,9000,0.99,13.43,0,0.99
"2686",2686,"Lost Horizon",67000,76000,9000,9.99,13.43,70,2.99
"2687",2687,"The Interactive Adventures of Dog Mendonça & Pizzaboy",67000,76000,9000,14.99,13.43,80,2.99
"2688",2688,"Distrust",46000,76000,30000,11.99,65.22,85,1.79
"2689",2689,"The Lost Crown",73000,76000,3000,9.99,4.11,80,1.99
"2690",2690,"Rhino's Rage",48000,76000,28000,4.99,58.33,0,4.99
"2691",2691,"DOKA 2 KISHKI EDITION",0,76000,76000,0.99,0,51,0.49
"2692",2692,"LocoSoccer",35000,75000,40000,0.99,114.29,51,0.49
"2693",2693,"Carmageddon 2: Carpocalypse Now",45000,75000,30000,9.99,66.67,75,2.49
"2694",2694,"Assassin’s Creed Chronicles: Russia",43000,75000,32000,9.99,74.42,66,3.39
"2695",2695,"Coffin Dodgers",59000,75000,16000,10.99,27.12,90,1.09
"2696",2696,"Space Empires IV Deluxe",70000,75000,5000,9.99,7.14,80,1.99
"2697",2697,"Thief Simulator",0,75000,75000,19.99,0,15,16.99
"2698",2698,"Aveyond 3-1: Lord of Twilight",53000,75000,22000,9.99,41.51,80,1.99
"2699",2699,"XIII Century – Gold Edition",73000,75000,2000,4.99,2.74,80,0.99
"2700",2700,"Doorways: The Underworld",70000,75000,5000,9.99,7.14,70,2.99
"2701",2701,"Grow Up",67000,75000,8000,9.99,11.94,75,2.49
"2702",2702,"Day D: Tower Rush",56000,75000,19000,4.99,33.93,90,0.49
"2703",2703,"Glittermitten Grove",39000,75000,36000,19.99,92.31,60,7.99
"2704",2704,"Sorcery! Parts 1 and 2",40000,75000,35000,9.99,87.5,65,3.49
"2705",2705,"Intelligent Design: An Evolutionary Sandbox",67000,74000,7000,6.99,10.45,60,2.79
"2706",2706,"The Deadly Tower of Monsters",59000,74000,15000,14.99,25.42,80,2.99
"2707",2707,"Mr. Shifty",69000,74000,5000,14.99,7.25,67,4.94
"2708",2708,"Crowntakers",67000,74000,7000,9.99,10.45,80,1.99
"2709",2709,"Call of Cthulhu",0,74000,74000,44.99,0,0,44.99
"2710",2710,"侠客风云传(Tale of Wuxia)",64000,74000,10000,16.99,15.63,0,16.99
"2711",2711,"Basement",59000,74000,15000,9.99,25.42,0,9.99
"2712",2712,"In Verbis Virtus",69000,74000,5000,19.99,7.25,75,4.99
"2713",2713,"The Last Patient",63000,74000,11000,0.99,17.46,51,0.49
"2714",2714,"Agricultural Simulator: Historical Farming",70000,74000,4000,9.99,5.71,70,2.99
"2715",2715,"Dream Dealer",53000,74000,21000,3.99,39.62,85,0.59
"2716",2716,"Thronebreaker: The Witcher Tales",0,74000,74000,29.99,0,0,29.99
"2717",2717,"ROTii",67000,74000,7000,0.99,10.45,0,0.99
"2718",2718,"Way of the Samurai 4",67000,74000,7000,24.99,10.45,70,7.49
"2719",2719,"Mahjong Deluxe 3",52000,74000,22000,3.99,42.31,80,0.79
"2720",2720,"The Deed: Dynasty",69000,74000,5000,2.99,7.25,83,0.5
"2721",2721,"Slap City",7000,74000,67000,6.99,957.14,50,3.49
"2722",2722,"Gunmetal Arcadia Zero",71000,74000,3000,5.99,4.23,50,2.99
"2723",2723,"Toadled",58000,74000,16000,0.99,27.59,51,0.49
"2724",2724,"Carmageddon TDR 2000",70000,74000,4000,4.99,5.71,75,1.24
"2725",2725,"ABC Coloring Town",56000,74000,18000,1.99,32.14,80,0.49
"2726",2726,"Rakuen",47000,73000,26000,9.99,55.32,50,4.99
"2727",2727,"Delicious! Pretty Girls Mahjong Solitaire",64000,73000,9000,0.99,14.06,20,0.79
"2728",2728,"Khet 2.0",59000,73000,14000,9.99,23.73,75,2.49
"2729",2729,"Chronicles of a Dark Lord: Episode II War of The Abyss",46000,73000,27000,2.99,58.7,70,0.89
"2730",2730,"Blue Estate The Game",69000,73000,4000,12.99,5.8,75,3.24
"2731",2731,"ETHER VAPOR Remaster",63000,73000,10000,7.99,15.87,50,3.99
"2732",2732,"Crash Drive 2",60000,73000,13000,4.99,21.67,80,0.99
"2733",2733,"Windforge",71000,73000,2000,9.99,2.82,50,4.99
"2734",2734,"Theatre of War 3: Korea",67000,73000,6000,6.99,8.96,80,1.39
"2735",2735,"99 Levels To Hell",71000,73000,2000,4.99,2.82,70,1.49
"2736",2736,"WRC 4 FIA World Rally Championship",69000,73000,4000,29.99,5.8,80,5.99
"2737",2737,"Ride 2",54000,73000,19000,49.99,35.19,75,12.49
"2738",2738,"Throne of Lies The Online Game of Deceit",46000,73000,27000,9.99,58.7,51,4.89
"2739",2739,"Face Noir",69000,73000,4000,9.99,5.8,75,2.49
"2740",2740,"PixelJunk Nom Nom Galaxy",54000,73000,19000,9.99,35.19,50,4.99
"2741",2741,"Pain Train",51000,72000,21000,0.99,41.18,51,0.49
"2742",2742,"Bus Simulator 18",29000,72000,43000,34.99,148.28,20,27.99
"2743",2743,"eXceed 3rd - Jade Penetrate Black Package",56000,72000,16000,5.99,28.57,50,2.99
"2744",2744,"Shadowgate: MacVenture Series",50000,72000,22000,2.99,44,0,2.99
"2745",2745,"Mahsung Deluxe",63000,72000,9000,0.99,14.29,75,0.49
"2746",2746,"Mini Golf Mundo",40000,72000,32000,2.99,80,80,0.59
"2747",2747,"Soul at Stake",0,72000,72000,17.99,0,40,10.79
"2748",2748,"Wayout",66000,72000,6000,0.99,9.09,51,0.49
"2749",2749,"Farm Life: Natures Adventure",35000,72000,37000,0.99,105.71,51,0.49
"2750",2750,"REVOLVER360 RE:ACTOR",47000,72000,25000,9.99,53.19,70,2.99
"2751",2751,"Deadlings: Rotten Edition",69000,72000,3000,3.99,4.35,0,3.99
"2752",2752,"Dark Fall: The Journal",64000,72000,8000,4.99,12.5,75,1.24
"2753",2753,"FOTONICA",67000,72000,5000,14.99,7.46,90,1.49
"2754",2754,"Agony",60000,72000,12000,14.99,20,60,5.99
"2755",2755,"Unstoppable Gorg",69000,72000,3000,9.99,4.35,90,0.99
"2756",2756,"The Dwarves",32000,72000,40000,39.99,125,75,9.99
"2757",2757,"Trackmania Turbo",50000,72000,22000,39.99,44,70,11.99
"2758",2758,"RUSSIA BATTLEGROUNDS",0,72000,72000,0.99,0,51,0.49
"2759",2759,"Super Motherload",62000,72000,10000,14.99,16.13,75,3.74
"2760",2760,"Conan the mighty pig",68000,71000,3000,0.99,4.41,51,0.49
"2761",2761,"Diehard Dungeon",66000,71000,5000,4.99,7.58,90,0.49
"2762",2762,"Secret of Mana",42000,71000,29000,39.99,69.05,50,19.99
"2763",2763,"Horizon",60000,71000,11000,29.99,18.33,80,5.99
"2764",2764,"冒险村传说（Tales of Legends）",40000,71000,31000,1.99,77.5,0,1.99
"2765",2765,"Autumn",62000,71000,9000,2.99,14.52,75,0.74
"2766",2766,"This Is the Police 2",0,71000,71000,14.99,0,25,11.24
"2767",2767,"Freddi Fish and the Case of the Missing Kelp Seeds",65000,71000,6000,6.99,9.23,60,2.79
"2768",2768,"Angels Fall First",57000,71000,14000,17.99,24.56,40,10.79
"2769",2769,"Gray Matter",67000,71000,4000,9.99,5.97,50,4.99
"2770",2770,"BlackSmith HIT",64000,71000,7000,0.99,10.94,51,0.49
"2771",2771,"Grandia II Anniversary Edition",68000,71000,3000,19.99,4.41,50,9.99
"2772",2772,"Split/Second",68000,71000,3000,19.99,4.41,0,19.99
"2773",2773,"Our Darker Purpose",69000,71000,2000,14.99,2.9,0,14.99
"2774",2774,"CLANNAD",55000,71000,16000,49.99,29.09,65,17.49
"2775",2775,"Alien Shooter: Revisited",60000,71000,11000,4.99,18.33,65,1.74
"2776",2776,"Frederic: Resurrection of Music Director's Cut",66000,71000,5000,5.99,7.58,90,0.59
"2777",2777,"OTTTD",45000,71000,26000,7.99,57.78,65,2.79
"2778",2778,"MXGP - The Official Motocross Videogame",49000,71000,22000,19.99,44.9,80,3.99
"2779",2779,"Cryptocurrency Clicker",55000,71000,16000,1.99,29.09,50,0.99
"2780",2780,"Devil May Cry HD Collection",31000,70000,39000,29.99,125.81,34,19.79
"2781",2781,"Nine Parchments",35000,70000,35000,19.99,100,75,4.99
"2782",2782,"Off-Road Drive",43000,70000,27000,4.99,62.79,75,1.24
"2783",2783,"Mahjong Destiny",60000,70000,10000,1.99,16.67,80,0.49
"2784",2784,"Rusty Lake Paradise",48000,70000,22000,3.99,45.83,50,1.99
"2785",2785,"Hamlet or the Last Game without MMORPG Features, Shaders ...",60000,70000,10000,4.99,16.67,90,0.49
"2786",2786,"I am Weapon: Revival",22000,70000,48000,15.99,218.18,90,1.59
"2787",2787,"Duckles: the Jigsaw Witch",59000,70000,11000,9.99,18.64,80,1.99
"2788",2788,"Beware Planet Earth",65000,70000,5000,9.99,7.69,80,1.99
"2789",2789,"Gal*Gun: Double Peace",67000,70000,3000,39.99,4.48,80,7.99
"2790",2790,"Steampunk Syndicate",64000,70000,6000,1.99,9.38,0,1.99
"2791",2791,"Astrox: Hostile Space Excavation",33000,70000,37000,9.99,112.12,70,2.99
"2792",2792,"Luna Sky",68000,70000,2000,12.99,2.94,90,1.29
"2793",2793,"OCEAN CITY RACING: Redux",48000,70000,22000,2.99,45.83,75,0.74
"2794",2794,"Heliborne",53000,70000,17000,19.99,32.08,40,11.99
"2795",2795,"Crazy Machines 3",54000,70000,16000,9.99,29.63,66,3.39
"2796",2796,"Fruit Ninja VR",64000,69000,5000,14.99,7.81,35,9.74
"2797",2797,"Fortissimo FA",7000,69000,62000,9.99,885.71,60,3.99
"2798",2798,"Among the Heavens",63000,69000,6000,2.99,9.52,83,0.5
"2799",2799,"FlatOut 4: Total Insanity",32000,69000,37000,29.99,115.63,85,4.49
"2800",2800,"LEGO Marvel Super Heroes 2",53000,69000,16000,39.99,30.19,75,9.99
"2801",2801,"Bang Bang Racing",67000,69000,2000,9.99,2.99,75,2.49
"2802",2802,"Masked Forces",21000,69000,48000,0.99,228.57,51,0.49
"2803",2803,"Blade Kitten",67000,69000,2000,2.99,2.99,75,0.74
"2804",2804,"SolarGun",43000,69000,26000,0.99,60.47,51,0.49
"2805",2805,"Mountain Crime: Requital",63000,69000,6000,2.99,9.52,70,0.89
"2806",2806,"Cargo! The Quest for Gravity",67000,69000,2000,9.99,2.99,80,1.99
"2807",2807,"FootRock",66000,69000,3000,0.99,4.55,0,0.99
"2808",2808,"Phoenix Force",67000,69000,2000,3.99,2.99,88,0.49
"2809",2809,"Final Slam 2",62000,69000,7000,3.99,11.29,87,0.51
"2810",2810,"Sword of Asumi",61000,69000,8000,9.99,13.11,75,1.99
"2811",2811,"Blood Feed",48000,69000,21000,4.99,43.75,90,0.49
"2812",2812,"Super 3-D Noah's Ark",66000,69000,3000,4.99,4.55,55,2.24
"2813",2813,"MegaTagmension Blanc + Neptune VS Zombies (Neptunia)",48000,69000,21000,24.99,43.75,80,5.99
"2814",2814,"Automation - The Car Company Tycoon Game",46000,69000,23000,29.99,50,15,25.49
"2815",2815,"Woodcutter Simulator 2013",65000,69000,4000,9.99,6.15,70,2.99
"2816",2816,"Conquest of Elysium 4",13000,69000,56000,24.99,430.77,75,6.24
"2817",2817,"Meltdown",64000,69000,5000,6.99,7.81,70,2.09
"2818",2818,"Spy Fox in ""Dry Cereal""",58000,69000,11000,6.99,18.97,60,2.79
"2819",2819,"Rise & Shine",41000,69000,28000,14.99,68.29,60,5.99
"2820",2820,"Avernum 5",58000,69000,11000,4.99,18.97,70,1.49
"2821",2821,"Galaxy Admirals",59000,69000,10000,1.99,16.95,75,0.49
"2822",2822,"Marauder",64000,68000,4000,9.99,6.25,90,0.99
"2823",2823,"SUPERFIGHT",64000,68000,4000,9.99,6.25,0,9.99
"2824",2824,"Home Sweet Home",49000,68000,19000,16.99,38.78,0,16.99
"2825",2825,"We Are The Dwarves",50000,68000,18000,24.99,36,90,2.49
"2826",2826,"Max, an Autistic Journey",7000,68000,61000,4.99,871.43,90,0.59
"2827",2827,"Alien Hostage",56000,68000,12000,2.99,21.43,75,0.74
"2828",2828,"Insane 2",63000,68000,5000,14.99,7.94,60,5.99
"2829",2829,"Spectrum",45000,68000,23000,4.99,51.11,66,1.69
"2830",2830,"Legends of Persia",65000,68000,3000,19.99,4.62,85,2.99
"2831",2831,"Fly O'Clock",64000,68000,4000,0.99,6.25,51,0.49
"2832",2832,"Royal Defense",63000,68000,5000,4.99,7.94,90,0.49
"2833",2833,"Alum",60000,68000,8000,4.99,13.33,50,2.49
"2834",2834,"Auditorium",66000,68000,2000,6.99,3.03,0,6.99
"2835",2835,"Hard Truck Apocalypse / Ex Machina",53000,68000,15000,7.99,28.3,90,0.79
"2836",2836,"Joe Dever's Lone Wolf HD Remastered",63000,68000,5000,14.99,7.94,85,2.24
"2837",2837,"Changed",28000,68000,40000,5.99,142.86,20,4.79
"2838",2838,"KRUM - Edge Of Darkness",65000,68000,3000,2.99,4.62,60,1.19
"2839",2839,"GTR - FIA GT Racing Game",64000,68000,4000,6.99,6.25,50,3.49
"2840",2840,"Airport Simulator 2014",63000,68000,5000,9.99,7.94,75,2.49
"2841",2841,"Goetia",50000,68000,18000,14.99,36,80,2.99
"2842",2842,"Perfect Universe - Play with Gravity",50000,68000,18000,9.99,36,80,1.99
"2843",2843,"Take On Mars",65000,67000,2000,26.99,3.08,50,13.49
"2844",2844,"Silent Hunter: Wolves of the Pacific U-Boat Missions",63000,67000,4000,9.99,6.35,66,3.39
"2845",2845,"RPG Maker 2003",53000,67000,14000,19.99,26.42,80,3.99
"2846",2846,"Gumboy - Crazy Adventures",61000,67000,6000,4.99,9.84,75,1.24
"2847",2847,"Dominions 4: Thrones of Ascension",62000,67000,5000,34.99,8.06,75,8.74
"2848",2848,"Hexaball",11000,67000,56000,0.99,509.09,37,0.62
"2849",2849,"Another Brick in the Mall",58000,67000,9000,12.99,15.52,45,7.14
"2850",2850,"Yet Another World",56000,67000,11000,7.99,19.64,70,0.79
"2851",2851,"White Noise Online",64000,67000,3000,4.99,4.69,80,0.99
"2852",2852,"Out There: Ω Edition",62000,67000,5000,14.99,8.06,66,5.09
"2853",2853,"Zen vs Zombie (Achievment Hunter)",59000,67000,8000,1.99,13.56,75,0.49
"2854",2854,"I am Setsuna",63000,67000,4000,39.99,6.35,50,19.99
"2855",2855,"Momodora III",61000,67000,6000,1.99,9.84,0,1.99
"2856",2856,"Myst V: End of Ages",60000,67000,7000,9.99,11.67,65,3.49
"2857",2857,"Oriental Empires",58000,67000,9000,29.99,15.52,66,10.19
"2858",2858,"Antisquad",55000,67000,12000,5.99,21.82,0,5.99
"2859",2859,"Tex Murphy: Under a Killing Moon",54000,67000,13000,9.99,24.07,80,1.99
"2860",2860,"Flinthook",52000,67000,15000,14.99,28.85,50,7.49
"2861",2861,"Sugar Box",48000,66000,18000,1.99,37.5,75,0.49
"2862",2862,"House of 1,000 Doors: Family Secrets Collector's Edition",45000,66000,21000,9.99,46.67,50,4.99
"2863",2863,"Party Panic",43000,66000,23000,16.99,53.49,50,8.49
"2864",2864,"The Last Federation",57000,66000,9000,19.99,15.79,80,3.99
"2865",2865,"Riff Racer - Race Your Music!",55000,66000,11000,9.99,20,75,2.49
"2866",2866,"武侠乂 The Swordsmen X",0,66000,66000,24.99,0,50,12.49
"2867",2867,"Forgotten, Not Lost - A Kinetic Novel",63000,66000,3000,1.99,4.76,65,0.69
"2868",2868,"Gratuitous Tank Battles",62000,66000,4000,9.99,6.45,70,2.99
"2869",2869,"Arsenal of Democracy: A Hearts of Iron Game",59000,66000,7000,9.99,11.86,75,2.49
"2870",2870,"Drunken Robot Pornography",63000,66000,3000,14.99,4.76,78,3.29
"2871",2871,"Multishop Tycoon Deluxe",31000,66000,35000,6.99,112.9,60,2.79
"2872",2872,"Toren",61000,66000,5000,9.99,8.2,75,2.49
"2873",2873,"Avadon 2: The Corruption",62000,66000,4000,9.99,6.45,70,2.99
"2874",2874,"Ys VI: The Ark of Napishtim",55000,66000,11000,19.99,20,70,5.99
"2875",2875,"The Uncertain: Last Quiet Day",55000,66000,11000,14.99,20,90,1.49
"2876",2876,"Shadow Puppeteer",63000,66000,3000,14.99,4.76,75,3.74
"2877",2877,"Primal Fears",62000,66000,4000,9.99,6.45,80,1.99
"2878",2878,"Reversion - The Meeting (2nd Chapter)",62000,66000,4000,4.99,6.45,50,2.49
"2879",2879,"SEUM: Speedrunners from Hell",47000,66000,19000,14.99,40.43,70,4.49
"2880",2880,"Taimumari",48000,66000,18000,4.99,37.5,75,1.24
"2881",2881,"SpaceCorn",58000,66000,8000,0.99,13.79,51,0.49
"2882",2882,"Rhiannon: Curse of the Four Branches",60000,65000,5000,4.99,8.33,80,0.99
"2883",2883,"Time Mysteries: Inheritance - Remastered",62000,65000,3000,9.99,4.84,70,2.99
"2884",2884,"Tcheco in the Castle of Lucio",54000,65000,11000,0.99,20.37,51,0.49
"2885",2885,"CHUCHEL",35000,65000,30000,9.99,85.71,33,6.69
"2886",2886,"Sally Face",25000,65000,40000,2.99,160,33,2
"2887",2887,"Haunt the House: Terrortown",63000,65000,2000,4.99,3.17,80,0.99
"2888",2888,"Zombie Bowl-o-Rama",43000,65000,22000,9.99,51.16,60,3.99
"2889",2889,"Marmoset Hexels 3",43000,65000,22000,49,51.16,50,24.5
"2890",2890,"Dark Shadows - Army of Evil",61000,65000,4000,4.99,6.56,80,0.99
"2891",2891,"Atelier Sophie: The Alchemist of the Mysterious Book",60000,65000,5000,29.99,8.33,30,20.99
"2892",2892,"Bulletstorm: Full Clip Edition",36000,65000,29000,39.99,80.56,75,9.99
"2893",2893,"Holy Potatoes! We’re in Space?!",57000,65000,8000,14.99,14.04,75,3.74
"2894",2894,"Restaurant Empire II",60000,65000,5000,19.99,8.33,75,4.99
"2895",2895,"Mike was Сursed",15000,65000,50000,11.99,333.33,40,7.19
"2896",2896,"Save the Ninja Clan",56000,65000,9000,0.99,16.07,51,0.49
"2897",2897,"East India Company",61000,65000,4000,9.99,6.56,0,9.99
"2898",2898,"Dessert Storm",33000,65000,32000,0.99,96.97,75,0.49
"2899",2899,"Heroes of Annihilated Empires",54000,65000,11000,14.99,20.37,80,2.99
"2900",2900,"VoxreD",56000,64000,8000,0.99,14.29,51,0.49
"2901",2901,"Democracy 3 Africa",36000,64000,28000,14.99,77.78,75,3.74
"2902",2902,"Duskers",61000,64000,3000,19.99,4.92,50,9.99
"2903",2903,"The Dolls: Reborn",58000,64000,6000,4.99,10.34,90,0.49
"2904",2904,"The Brookhaven Experiment",55000,64000,9000,19.99,16.36,80,3.99
"2905",2905,"Ghost 1.0",57000,64000,7000,12.99,12.28,65,4.54
"2906",2906,"Snake Party",47000,64000,17000,0.99,36.17,51,0.49
"2907",2907,"AMOK",55000,64000,9000,0.99,16.36,51,0.49
"2908",2908,"Age of Gladiators",36000,64000,28000,9.99,77.78,80,1.99
"2909",2909,"Judgment: Apocalypse Survival Simulation",59000,64000,5000,19.99,8.47,20,15.99
"2910",2910,"NARUTO TO BORUTO: SHINOBI STRIKER",0,64000,64000,49.99,0,50,24.99
"2911",2911,"Escape Dead Island",60000,64000,4000,14.99,6.67,75,3.74
"2912",2912,"Gabriel Knight: Sins of the Fathers 20th Anniversary Edition",48000,64000,16000,19.99,33.33,75,4.99
"2913",2913,"Story Of the Survivor",61000,64000,3000,4.99,4.92,50,2.49
"2914",2914,"Midnight Mysteries 4: Haunted Houdini",59000,63000,4000,9.99,6.78,60,3.99
"2915",2915,"Angels of Death",27000,63000,36000,9.99,133.33,50,4.99
"2916",2916,"Live Wallpaper Master",31000,63000,32000,3.99,103.23,10,3.59
"2917",2917,"Sanitarium",55000,63000,8000,9.99,14.55,50,4.99
"2918",2918,"Bravada",7000,63000,56000,9.99,800,80,1.99
"2919",2919,"Hegemony Rome: The Rise of Caesar",61000,63000,2000,14.99,3.28,80,2.99
"2920",2920,"WORLD END ECONOMiCA episode.02",31000,63000,32000,12.99,103.23,75,3.24
"2921",2921,"Super Galaxy Squadron EX Turbo",43000,63000,20000,9.99,46.51,66,3.39
"2922",2922,"Death's Gambit",0,63000,63000,19.99,0,40,11.99
"2923",2923,"The Wardrobe",13000,63000,50000,14.99,384.62,60,5.99
"2924",2924,"Bot Vice",29000,63000,34000,4.99,117.24,75,0.49
"2925",2925,"Razenroth",54000,63000,9000,4.99,16.67,90,0.49
"2926",2926,"Ignite",61000,63000,2000,9.99,3.28,0,9.99
"2927",2927,"Lethal League Blaze",0,63000,63000,19.99,0,0,19.99
"2928",2928,"Subject 13",49000,63000,14000,9.99,28.57,50,4.99
"2929",2929,"SENRAN KAGURA Peach Beach Splash",32000,63000,31000,39.99,96.88,40,23.99
"2930",2930,"The Settlers: Rise Of An Empire Gold Edition",56000,63000,7000,19.99,12.5,75,4.99
"2931",2931,"Girl Amazon Survival",45000,63000,18000,2.99,40,74,0.77
"2932",2932,"TY the Tasmanian Tiger",54000,63000,9000,14.99,16.67,55,6.74
"2933",2933,"River City Ransom: Underground",58000,63000,5000,19.99,8.62,85,2.99
"2934",2934,"Shan Gui (山桂)",60000,63000,3000,0.99,5,0,0.99
"2935",2935,"Shadow Man",51000,63000,12000,4.99,23.53,80,0.99
"2936",2936,"Alpha Kimori 1",56000,63000,7000,9.99,12.5,30,6.99
"2937",2937,"Catlateral Damage",48000,63000,15000,9.99,31.25,75,2.49
"2938",2938,"Warhammer 40,000: Gladius - Relics of War",0,63000,63000,39.99,0,25,29.99
"2939",2939,"Star Ruler 2",53000,63000,10000,24.99,18.87,75,6.24
"2940",2940,"Insurgency: Sandstorm",0,63000,63000,29.99,0,10,26.99
"2941",2941,"Weable",50000,63000,13000,0.99,26,35,0.64
"2942",2942,"Grobda Remix",40000,62000,22000,1.99,55,70,0.59
"2943",2943,"The Council",21000,62000,41000,29.99,195.24,50,14.99
"2944",2944,"FATE: Undiscovered Realms",45000,62000,17000,7.99,37.78,0,7.99
"2945",2945,"Batman: Arkham VR",56000,62000,6000,19.99,10.71,50,9.99
"2946",2946,"Vox Populi Vox Dei 2",60000,62000,2000,2.99,3.33,83,0.5
"2947",2947,"Dyscourse",48000,62000,14000,14.99,29.17,0,14.99
"2948",2948,"Collapse",56000,62000,6000,19.99,10.71,90,1.99
"2949",2949,"Velocity 2X",51000,62000,11000,19.99,21.57,75,4.99
"2950",2950,"Distant Worlds: Universe",59000,62000,3000,59.99,5.08,75,14.99
"2951",2951,"Brave Dungeon",58000,62000,4000,0.99,6.9,51,0.49
"2952",2952,"Balloon Blowout",55000,62000,7000,0.99,12.73,75,0.49
"2953",2953,"eXceed 2nd - Vampire REX",47000,62000,15000,5.99,31.91,50,2.99
"2954",2954,"Staxel",44000,62000,18000,19.99,40.91,25,14.99
"2955",2955,"Pro Cycling Manager 2017",57000,62000,5000,29.99,8.77,75,7.49
"2956",2956,"18 Wheels of Steel: American Long Haul",59000,62000,3000,9.99,5.08,65,3.49
"2957",2957,"RIDE",52000,62000,10000,19.99,19.23,75,4.99
"2958",2958,"Soundodger+",59000,62000,3000,7.99,5.08,80,1.59
"2959",2959,"The Moon Sliver",59000,62000,3000,1.99,5.08,60,0.79
"2960",2960,"STASIS",48000,62000,14000,9.99,29.17,72,5.59
"2961",2961,"Bear With Me - Collector's Edition",13000,62000,49000,9.98,376.92,30,6.98
"2962",2962,"What The Box?",47000,62000,15000,4.99,31.91,40,2.99
"2963",2963,"BLOCK WARRIORS: ""Open World"" Game",15000,61000,46000,1.99,306.67,0,1.99
"2964",2964,"Rend",0,61000,61000,29.99,0,66,10.19
"2965",2965,"LEGO Indiana Jones: The Original Adventures",56000,61000,5000,19.99,8.93,66,6.79
"2966",2966,"Zombie Kill of the Week - Reborn",58000,61000,3000,6.99,5.17,90,0.69
"2967",2967,"WRC 7 FIA World Rally Championship",39000,61000,22000,39.99,56.41,70,11.99
"2968",2968,"Wings of Vi",53000,61000,8000,14.99,15.09,35,9.74
"2969",2969,"Lili: Child of Geos - Complete Edition",57000,61000,4000,14.99,7.02,65,5.24
"2970",2970,"Bang Bang Fruit",55000,61000,6000,0.99,10.91,51,0.49
"2971",2971,"Sports Bar VR",54000,61000,7000,19.99,12.96,50,9.99
"2972",2972,"Heart and Seoul",18000,61000,43000,2.99,238.89,75,0.74
"2973",2973,"The Dweller",51000,61000,10000,4.99,19.61,90,0.49
"2974",2974,"The Purring Quest",54000,61000,7000,9.99,12.96,86,1.39
"2975",2975,"3 Coins At School",43000,61000,18000,4.99,41.86,90,0.49
"2976",2976,"Fire Pro Wrestling World",55000,61000,6000,29.99,10.91,40,17.99
"2977",2977,"Starpoint Gemini",47000,61000,14000,13.99,29.79,85,2.09
"2978",2978,"Barnyard Mahjong 3",42000,61000,19000,1.99,45.24,80,0.49
"2979",2979,"Aseprite",49000,61000,12000,14.99,24.49,20,11.99
"2980",2980,"EvilQuest",59000,61000,2000,1.99,3.39,50,0.99
"2981",2981,"BROKE PROTOCOL: Online City RPG",14000,61000,47000,4.99,335.71,75,1.24
"2982",2982,"Goats on a Bridge",58000,61000,3000,4.99,5.17,80,0.99
"2983",2983,"Fishing: Barents Sea",31000,61000,30000,24.99,96.77,20,15.99
"2984",2984,"LOVE",57000,61000,4000,2.99,7.02,75,0.74
"2985",2985,"Enigmatis 3: The Shadow of Karkhala",38000,61000,23000,9.99,60.53,50,4.99
"2986",2986,"Return of the Obra Dinn",0,61000,61000,19.99,0,0,19.99
"2987",2987,"WARRIORS OROCHI 4 - 無双OROCHI３",0,61000,61000,59.99,0,10,53.99
"2988",2988,"Trailmakers",42000,61000,19000,19.99,45.24,40,11.99
"2989",2989,"Guns, Gore and Cannoli 2",28000,61000,33000,12.99,117.86,33,8.7
"2990",2990,"8-Bit Commando",56000,60000,4000,2.99,7.14,50,1.49
"2991",2991,"Hit Tank PRO",33000,60000,27000,2.99,81.82,83,0.5
"2992",2992,"War of the Human Tanks",50000,60000,10000,9.99,20,75,2.49
"2993",2993,"Battle of Empires : 1914-1918",51000,60000,9000,8.99,17.65,75,2.24
"2994",2994,"Planet R-12",58000,60000,2000,0.99,3.45,51,0.49
"2995",2995,"Tex Murphy: Overseer",52000,60000,8000,9.99,15.38,80,1.99
"2996",2996,"The Count Lucanor",57000,60000,3000,9.99,5.26,80,1.99
"2997",2997,"Minecraft: Story Mode - Season Two",45000,60000,15000,14.99,33.33,50,12.49
"2998",2998,"SATAZIUS",51000,60000,9000,5.99,17.65,50,2.99
"2999",2999,"Evil Spring: Student Holidays",0,60000,60000,5.99,0,15,5.09
"3000",3000,"Deathgarden",0,60000,60000,29.99,0,0,29.99
"3001",3001,"Killer Instinct",53000,60000,7000,39.99,13.21,75,9.99
"3002",3002,"3089 -- Futuristic Action RPG",57000,60000,3000,6.99,5.26,75,1.74
"3003",3003,"Maia",30000,60000,30000,24.99,100,50,12.49
"3004",3004,"Fingered",55000,60000,5000,1.87,9.09,0,1.87
"3005",3005,"Gundemonium Recollection",44000,60000,16000,3.99,36.36,0,3.99
"3006",3006,"Mutant Year Zero: Road to Eden",1000,60000,59000,34.99,5900,0,34.99
"3007",3007,"Magnifico",47000,60000,13000,4.99,27.66,75,1.24
"3008",3008,"GundeadliGne",57000,60000,3000,3.99,5.26,0,3.99
"3009",3009,"Captivity",45000,60000,15000,0.99,33.33,37,0.62
"3010",3010,"Cat Girl",44000,60000,16000,0.99,36.36,51,0.49
"3011",3011,"Luke Sidewalker",53000,60000,7000,0.99,13.21,51,0.49
"3012",3012,"The Swords of Ditto",33000,60000,27000,19.99,81.82,50,9.99
"3013",3013,"Forged Battalion",19000,59000,40000,19.99,210.53,50,9.99
"3014",3014,"Cinders",56000,59000,3000,19.99,5.36,70,5.99
"3015",3015,"Another Adventure",54000,59000,5000,1.99,9.26,0,1.99
"3016",3016,"Sumo Revise",53000,59000,6000,4.99,11.32,0,4.99
"3017",3017,"Fantastic 4 In A Row 2",57000,59000,2000,0.99,3.51,75,0.49
"3018",3018,"Luxor: 5th Passage",56000,59000,3000,9.99,5.36,60,3.99
"3019",3019,"Zotrix",48000,59000,11000,12.99,22.92,75,3.24
"3020",3020,"Chariot",53000,59000,6000,14.99,11.32,40,8.99
"3021",3021,"Sunset Overdrive",0,59000,59000,19.99,0,0,19.99
"3022",3022,"Zombitatos the end of the Pc master race",50000,59000,9000,1.99,18,51,0.49
"3023",3023,"Rush for Glory",55000,59000,4000,14.99,7.27,75,3.74
"3024",3024,"Children of the Nile: Enhanced Edition",56000,59000,3000,7.99,5.36,0,7.99
"3025",3025,"Notruf 112 | Emergency Call 112",54000,59000,5000,29.99,9.26,40,17.99
"3026",3026,"Shadows: Price For Our Sins Bonus Edition",53000,59000,6000,9.99,11.32,75,2.49
"3027",3027,"Press X to Not Die",53000,59000,6000,2.99,11.32,80,0.59
"3028",3028,"Expand",56000,59000,3000,5.99,5.36,70,1.79
"3029",3029,"Twilight Struggle",51000,59000,8000,9.99,15.69,60,3.99
"3030",3030,"Hungry Flame",53000,59000,6000,4.99,11.32,90,0.49
"3031",3031,"while True: learn()",10000,59000,49000,6.99,490,17,5.8
"3032",3032,"Paranormal State: Poison Spring",37000,59000,22000,9.99,59.46,85,1.49
"3033",3033,"Water Bears VR",54000,59000,5000,9.99,9.26,60,3.99
"3034",3034,"My Super Tower 2",11000,59000,48000,0.99,436.36,51,0.49
"3035",3035,"No Way Out",22000,59000,37000,0.99,168.18,51,0.49
"3036",3036,"Bloo Kid 2",52000,58000,6000,3.99,11.54,0,3.99
"3037",3037,"Spaceship Looter",38000,58000,20000,9.99,52.63,70,2.99
"3038",3038,"Star Control: Origins",6000,58000,52000,39.99,866.67,25,29.99
"3039",3039,"Infectonator: Survivors",49000,58000,9000,9.99,18.37,80,1.99
"3040",3040,"Fantastic Checkers 2",53000,58000,5000,0.99,9.43,75,0.49
"3041",3041,"Quarantine Circular",1000,58000,57000,5.99,5700,20,4.79
"3042",3042,"GO AWAY, THERE'S KUMIS OVER THERE!",54000,58000,4000,0.99,7.41,51,0.49
"3043",3043,"BlackShadows",55000,58000,3000,2.99,5.45,0,2.99
"3044",3044,"Bio Inc. Redemption",45000,58000,13000,12.99,28.89,30,9.09
"3045",3045,"Soul Axiom",45000,58000,13000,19.99,28.89,70,5.99
"3046",3046,"Reigns: Her Majesty",53000,58000,5000,2.99,9.43,50,1.49
"3047",3047,"WORLD OF FINAL FANTASY",36000,58000,22000,24.99,61.11,56,17.59
"3048",3048,"Tank Assault X",49000,58000,9000,1.99,18.37,60,0.79
"3049",3049,"AER Memories of Old",32000,58000,26000,14.99,81.25,50,7.49
"3050",3050,"Pro Cycling Manager 2016",50000,58000,8000,19.99,16,66,6.79
"3051",3051,"Defunct",37000,58000,21000,9.99,56.76,90,0.99
"3052",3052,"Hitogata Happa",56000,58000,2000,3.99,3.57,0,3.99
"3053",3053,"Medieval Kingdom Wars",42000,58000,16000,19.99,38.1,55,8.99
"3054",3054,"Ken Follett's The Pillars of the Earth",43000,58000,15000,29.99,34.88,60,11.99
"3055",3055,"Pajama Sam: No Need to Hide When It's Dark Outside",56000,58000,2000,6.99,3.57,60,2.79
"3056",3056,"Bejeweled 2 Deluxe",56000,58000,2000,4.99,3.57,75,1.24
"3057",3057,"Kingsway",49000,57000,8000,9.99,16.33,60,3.99
"3058",3058,"Lords of the Realm II",45000,57000,12000,2.99,26.67,66,1.01
"3059",3059,"Negligee",38000,57000,19000,12.99,50,45,5.49
"3060",3060,"Numen: Contest of Heroes",55000,57000,2000,7.99,3.64,75,1.99
"3061",3061,"Vampire Legends: The True Story of Kisilova",50000,57000,7000,9.99,14,70,2.99
"3062",3062,"Nimbus",55000,57000,2000,9.99,3.64,75,2.49
"3063",3063,"The Way",48000,57000,9000,14.99,18.75,80,2.99
"3064",3064,"Zafehouse: Diaries",44000,57000,13000,1.99,29.55,50,0.99
"3065",3065,"Zeus + Poseidon",46000,57000,11000,9.99,23.91,75,2.49
"3066",3066,"Bayla Bunny",51000,57000,6000,1.99,11.76,80,0.49
"3067",3067,"Solitaire Christmas. Match 2 Cards",38000,57000,19000,4.99,50,90,0.49
"3068",3068,"Luxor Evolved",51000,57000,6000,9.99,11.76,60,3.99
"3069",3069,"Galactic Arms Race",47000,57000,10000,2.99,21.28,0,2.99
"3070",3070,"Kitty Cat: Jigsaw Puzzles",50000,57000,7000,0.99,14,75,0.49
"3071",3071,"Crea",43000,57000,14000,14.99,32.56,40,8.99
"3072",3072,"Hyperdevotion Noire: Goddess Black Heart (Neptunia)",47000,57000,10000,24.99,21.28,85,3.99
"3073",3073,"Block Blowout",42000,57000,15000,0.99,35.71,75,0.49
"3074",3074,"Eryi's Action",52000,57000,5000,4.99,9.62,50,2.49
"3075",3075,"The Last NightMary - A Lenda do Cabeça de Cuia",49000,57000,8000,3.99,16.33,90,0.49
"3076",3076,"Helicopter Simulator 2014: Search and Rescue",51000,57000,6000,6.99,11.76,90,0.69
"3077",3077,"Gemini: Heroes Reborn",51000,57000,6000,4.99,11.76,80,0.99
"3078",3078,"Your Friend Hana",22000,57000,35000,0.99,159.09,33,0.66
"3079",3079,"Vector Thrust",35000,57000,22000,24.99,62.86,82,4.49
"3080",3080,"Zup! 7",36000,57000,21000,0.99,58.33,30,0.69
"3081",3081,"Dark Fall 2: Lights Out",41000,57000,16000,4.99,39.02,75,1.24
"3082",3082,"Overlord: Fellowship of Evil",52000,57000,5000,18.99,9.62,75,4.74
"3083",3083,"Winexy",39000,57000,18000,0.99,46.15,51,0.49
"3084",3084,"Assetto Corsa Competizione",0,57000,57000,34.99,0,0,24.99
"3085",3085,"The Orb Chambers II",38000,57000,19000,0.99,50,40,0.59
"3086",3086,"Fireflies",34000,57000,23000,1.99,67.65,0,1.99
"3087",3087,"Games&Girls",51000,56000,5000,1.99,9.8,25,1.49
"3088",3088,"Puzzles At Mystery Manor",39000,56000,17000,0.99,43.59,80,0.49
"3089",3089,"Porradaria 2: Pagode of the Night",42000,56000,14000,9.99,33.33,50,2.49
"3090",3090,"Kimulator : Fight for your destiny",53000,56000,3000,1.99,5.66,57,0.85
"3091",3091,"PAC-MAN CHAMPIONSHIP EDITION 2",44000,56000,12000,12.99,27.27,75,3.24
"3092",3092,"Ninja Stealth",53000,56000,3000,0.99,5.66,75,0.49
"3093",3093,"Darkstone",40000,56000,16000,4.99,40,80,0.99
"3094",3094,"1Quest",53000,56000,3000,3.99,5.66,0,3.99
"3095",3095,"idleBeer",30000,56000,26000,0.99,86.67,51,0.49
"3096",3096,"Prism Collider",50000,56000,6000,0.99,12,51,0.49
"3097",3097,"Blastercell",42000,56000,14000,0.99,33.33,51,0.49
"3098",3098,"Vangers",54000,56000,2000,6.99,3.7,0,6.99
"3099",3099,"LUXOR: Mah Jong",53000,56000,3000,9.99,5.66,60,3.99
"3100",3100,"Wildlife Park 2 - Fantasy",53000,56000,3000,0.99,5.66,33,0.66
"3101",3101,"Fairy Tale Mysteries 2: The Beanstalk",42000,56000,14000,9.99,33.33,70,2.99
"3102",3102,"Elementary My Dear Majesty!",35000,56000,21000,0.99,60,51,0.49
"3103",3103,"Gnomes Garden",32000,56000,24000,4.99,75,90,0.49
"3104",3104,"Warfare",54000,56000,2000,12.99,3.7,60,5.19
"3105",3105,"Kitty Powers' Matchmaker",53000,56000,3000,9.99,5.66,33,6.69
"3106",3106,"The Book of Legends",42000,56000,14000,14.99,33.33,90,1.49
"3107",3107,"SizeBlock",34000,56000,22000,1.99,64.71,75,0.49
"3108",3108,"oO",53000,56000,3000,0.99,5.66,33,0.66
"3109",3109,"Table Top Racing: World Tour",42000,56000,14000,9.99,33.33,80,1.99
"3110",3110,"Hero Battle",49000,56000,7000,6.99,14.29,0,0.99
"3111",3111,"LEGO Indiana Jones 2: The Adventure Continues",50000,56000,6000,19.99,12,66,6.79
"3112",3112,"The First Tree",43000,55000,12000,9.99,27.91,30,5.59
"3113",3113,"Subterrain",47000,55000,8000,16.99,17.02,70,5.09
"3114",3114,"Lift It",45000,55000,10000,4.99,22.22,90,0.49
"3115",3115,"I Can't Believe It's Not Gambling",33000,55000,22000,0.99,66.67,10,0.89
"3116",3116,"Firefighters 2014",52000,55000,3000,19.99,5.77,60,7.99
"3117",3117,"UFO: Aftershock",45000,55000,10000,3.99,22.22,80,0.79
"3118",3118,"Fleet Command",48000,55000,7000,9.99,14.58,80,1.99
"3119",3119,"VERSUS SQUAD",43000,55000,12000,7.99,27.91,75,1.99
"3120",3120,"Caves of Qud",40000,55000,15000,9.99,37.5,10,8.99
"3121",3121,"Laser League",29000,55000,26000,14.99,89.66,60,5.99
"3122",3122,"Detective Case and Clown Bot in: Murder in the Hotel Lisbon",46000,55000,9000,5.99,19.57,35,3.89
"3123",3123,"Hover",47000,55000,8000,19.99,17.02,60,7.99
"3124",3124,"Empires of the Undergrowth",47000,55000,8000,19.99,17.02,0,19.99
"3125",3125,"Little Jack's Adventures",51000,55000,4000,0.99,7.84,51,0.49
"3126",3126,"I Expect You To Die",42000,55000,13000,24.99,30.95,40,14.99
"3127",3127,"Chuzzle Deluxe",51000,55000,4000,4.99,7.84,75,1.24
"3128",3128,"Shooting Stars!",40000,55000,15000,4.99,37.5,90,0.49
"3129",3129,"Monster Bash",52000,55000,3000,4.99,5.77,50,2.49
"3130",3130,"Raiden IV: OverKill",39000,55000,16000,14.99,41.03,85,2.24
"3131",3131,"Life is Hard",50000,55000,5000,8.99,10,25,6.74
"3132",3132,"Whispers: Last Hope",38000,55000,17000,3.99,44.74,88,0.49
"3133",3133,"Vapour",51000,55000,4000,9.99,7.84,90,0.99
"3134",3134,"SickBrick",53000,55000,2000,19.99,3.77,90,1.99
"3135",3135,"One Day For Ched",47000,55000,8000,3.99,17.02,87,0.51
"3136",3136,"The Entente Gold",52000,55000,3000,1.99,5.77,75,0.49
"3137",3137,"Francisca",18000,55000,37000,0.99,205.56,51,0.49
"3138",3138,"Mad Father",41000,55000,14000,4.99,34.15,40,2.99
"3139",3139,"Blake Stone: Aliens of Gold",53000,55000,2000,4.99,3.77,50,2.49
"3140",3140,"Phantom Doctrine",0,55000,55000,39.99,0,30,27.99
"3141",3141,"Game Tycoon 2",40000,54000,14000,10.99,35,66,3.73
"3142",3142,"Tormentum - Dark Sorrow",50000,54000,4000,11.99,8,60,4.79
"3143",3143,"Aerial Destruction",25000,54000,29000,3.99,116,70,1.19
"3144",3144,"The Long Journey Home",39000,54000,15000,29.99,38.46,67,9.89
"3145",3145,"Pickers",51000,54000,3000,9.99,5.88,60,3.99
"3146",3146,"Zombillie",52000,54000,2000,4.99,3.85,90,0.49
"3147",3147,"Cockroach Simulator",36000,54000,18000,0.99,50,51,0.49
"3148",3148,"METAL SLUG 2",52000,54000,2000,6.99,3.85,50,3.49
"3149",3149,"SQR",49000,54000,5000,0.99,10.2,51,0.49
"3150",3150,"Tetrobot and Co.",51000,54000,3000,9.99,5.88,70,2.99
"3151",3151,"Sophie's Curse",49000,54000,5000,4.99,10.2,80,0.99
"3152",3152,"Signs of Life",49000,54000,5000,9.99,10.2,35,6.49
"3153",3153,"恋爱模拟器 Love Simulation",48000,54000,6000,1.99,12.5,40,1.19
"3154",3154,"15 Defense",50000,54000,4000,2.99,8,83,0.5
"3155",3155,"Turok 2: Seeds of Evil",43000,54000,11000,19.99,25.58,50,9.99
"3156",3156,"Mahjong Pretty Girls Battle",46000,54000,8000,14.99,17.39,90,1.49
"3157",3157,"Advent Rising",48000,54000,6000,9.99,12.5,85,1.49
"3158",3158,"Drakensang: The River of Time",52000,54000,2000,19.99,3.85,65,6.99
"3159",3159,"Madness Cubed",51000,54000,3000,1.99,5.88,50,0.99
"3160",3160,"Castle In The Darkness",51000,54000,3000,9.99,5.88,50,4.99
"3161",3161,"On A Roll 3D",39000,54000,15000,3.99,38.46,50,1.99
"3162",3162,"Pro Skater 2D",52000,54000,2000,0.99,3.85,51,0.49
"3163",3163,"Dysfunctional Systems: Learning to Manage Chaos",52000,54000,2000,4.99,3.85,70,1.49
"3164",3164,"The Archotek Project",48000,54000,6000,4.99,12.5,50,2.49
"3165",3165,"rFactor",47000,54000,7000,24.99,14.89,75,6.24
"3166",3166,"Samurai Wars",46000,54000,8000,4.99,17.39,45,1.64
"3167",3167,"Production Line : Car factory simulation",30000,53000,23000,19.99,76.67,30,13.99
"3168",3168,"Nethergate: Resurrection",51000,53000,2000,4.99,3.92,70,1.49
"3169",3169,"European Ship Simulator",46000,53000,7000,19.99,15.22,75,4.99
"3170",3170,"The Initial",30000,53000,23000,9.99,76.67,50,4.99
"3171",3171,"Aces Wild: Manic Brawling Action!",51000,53000,2000,9.99,3.92,50,4.99
"3172",3172,"Radium",51000,53000,2000,2.99,3.92,50,1.49
"3173",3173,"Flame of Memory",36000,53000,17000,1.99,47.22,50,0.99
"3174",3174,"GRIP: Combat Racing",41000,53000,12000,29.99,29.27,20,15.99
"3175",3175,"Bloodstained: Curse of the Moon",30000,53000,23000,9.99,76.67,30,6.99
"3176",3176,"DRAGON QUEST HEROES Slime Edition",51000,53000,2000,39.99,3.92,50,19.99
"3177",3177,"Empire TV Tycoon",42000,53000,11000,9.99,26.19,70,2.99
"3178",3178,"The Emerald Maiden: Symphony of Dreams",42000,53000,11000,9.99,26.19,70,2.99
"3179",3179,"Joana's Life",51000,53000,2000,5.99,3.92,50,2.99
"3180",3180,"House of the Dying Sun",49000,53000,4000,19.99,8.16,66,6.79
"3181",3181,"Koi-Koi Japan [Hanafuda playing cards]",47000,53000,6000,9.99,12.77,80,1.99
"3182",3182,"Timen runner",46000,53000,7000,0.99,15.22,51,0.49
"3183",3183,"WWE 2K17",50000,53000,3000,49.99,6,0,49.99
"3184",3184,"Mushroom Wars",45000,53000,8000,9.99,17.78,90,0.99
"3185",3185,"Curses 'N Chaos",51000,53000,2000,9.99,3.92,75,2.49
"3186",3186,"Yet Another Research Dog",10000,53000,43000,1.99,430,40,1.19
"3187",3187,"Secret Ponchos",47000,53000,6000,14.99,12.77,0,14.99
"3188",3188,"Manual Samuel",39000,53000,14000,9.99,35.9,70,2.99
"3189",3189,"Woodle Tree 2: Worlds",48000,53000,5000,3.99,10.42,60,1.59
"3190",3190,"Pixel-Warfare: Pro",18000,53000,35000,0.99,194.44,0,0.99
"3191",3191,"Automobilista",46000,53000,7000,29.99,15.22,75,7.49
"3192",3192,"Monochroma",47000,53000,6000,19.99,12.77,90,1.99
"3193",3193,"Escape Goat 2",49000,53000,4000,9.99,8.16,75,2.49
"3194",3194,"Boom-Bahh",47000,53000,6000,0.99,12.77,51,0.49
"3195",3195,"Serious Sam VR: The Last Hope",47000,53000,6000,39.99,12.77,66,13.59
"3196",3196,"Farm for your Life",50000,53000,3000,9.99,6,0,9.99
"3197",3197,"The Curse of Monkey Island",27000,53000,26000,6.99,96.3,25,5.24
"3198",3198,"Strange Brigade",0,53000,53000,49.99,0,40,29.99
"3199",3199,"THE GAME OF LIFE",37000,53000,16000,4.99,43.24,50,2.49
"3200",3200,"Blood Code",44000,53000,9000,6.99,20.45,73,1.88
"3201",3201,"Christmas Mission",8000,53000,45000,4.99,562.5,90,0.5
"3202",3202,"Emergency 2014",29000,53000,24000,9.99,82.76,35,6.49
"3203",3203,"Venetica - Gold Edition",40000,52000,12000,9.99,30,85,1.49
"3204",3204,"MotoGP13",44000,52000,8000,9.99,18.18,80,1.99
"3205",3205,"Night Mysteries: The Amphora Prisoner",42000,52000,10000,1.99,23.81,70,0.59
"3206",3206,"Abrix the robot",46000,52000,6000,9.99,13.04,65,3.49
"3207",3207,"Critter Crunch",43000,52000,9000,6.99,20.93,70,2.09
"3208",3208,"Chronicon",36000,52000,16000,9.99,44.44,20,7.99
"3209",3209,"My Name is Mayo",49000,52000,3000,0.99,6.12,0,0.99
"3210",3210,"The Last Door: Season 2 - Collector's Edition",46000,52000,6000,9.99,13.04,75,2.49
"3211",3211,"Suits: A Business RPG",49000,52000,3000,0.99,6.12,51,0.49
"3212",3212,"FRONTIERS",47000,52000,5000,14.99,10.64,0,14.99
"3213",3213,"Dungeon Warfare",43000,52000,9000,9.99,20.93,80,1.99
"3214",3214,"Executive Assault",34000,52000,18000,12.99,52.94,25,9.74
"3215",3215,"18 Wheels of Steel: Extreme Trucker",50000,52000,2000,9.99,4,65,3.49
"3216",3216,"Zombie Playground",49000,52000,3000,9.99,6.12,50,4.99
"3217",3217,"Flora's Fruit Farm",48000,52000,4000,3.99,8.33,76,0.95
"3218",3218,"Doorways: Holy Mountains of Flesh",48000,52000,4000,19.99,8.33,60,7.99
"3219",3219,"Lost Chronicles of Zerzura",44000,52000,8000,9.99,18.18,50,4.99
"3220",3220,"Homebrew - Patent Unknown",44000,52000,8000,14.99,18.18,80,2.99
"3221",3221,"Saint Seiya: Soldiers' Soul",41000,52000,11000,49.99,26.83,75,12.49
"3222",3222,"Strata",47000,52000,5000,7.99,10.64,0,3.99
"3223",3223,"Sweet fantasy",39000,52000,13000,3.99,33.33,50,1.99
"3224",3224,"Oik",43000,52000,9000,0.99,20.93,37,0.62
"3225",3225,"Leviathan: The Last Day of the Decade",49000,52000,3000,14.99,6.12,90,1.49
"3226",3226,"Tourists Kidnapped a Little Bear",44000,52000,8000,0.99,18.18,51,0.49
"3227",3227,"Bob Was Hungry",44000,52000,8000,9.99,18.18,90,0.99
"3228",3228,"Silver Knight",48000,52000,4000,1.99,8.33,75,0.49
"3229",3229,"Just Cause 4",0,52000,52000,59.99,0,0,59.99
"3230",3230,"Romance of the Three Kingdoms Maker / 三国志ツクール",35000,52000,17000,9.99,48.57,50,4.99
"3231",3231,"Onikira - Demon Killer",45000,52000,7000,13.99,15.56,90,1.39
"3232",3232,"SYNTHETIK: Legion Rising",18000,52000,34000,19.99,188.89,50,9.74
"3233",3233,"The Forest of Doom",50000,52000,2000,4.99,4,50,2.49
"3234",3234,"Real Warfare 1242",37000,51000,14000,3.99,37.84,75,0.99
"3235",3235,"Stationeers",34000,51000,17000,24.99,50,15,21.24
"3236",3236,"Demon Hunter: Chronicles from Beyond",49000,51000,2000,9.99,4.08,70,2.99
"3237",3237,"Disney TRON: Evolution",49000,51000,2000,19.99,4.08,65,6.99
"3238",3238,"古剑奇谭二(GuJian2)",44000,51000,7000,15.99,15.91,55,7.19
"3239",3239,"Maelstrom: The Battle for Earth Begins",44000,51000,7000,4.99,15.91,90,0.49
"3240",3240,"Micro Machines World Series",44000,51000,7000,29.99,15.91,75,7.49
"3241",3241,"Alex Hunter - Lord of the Mind Platinum Edition",48000,51000,3000,6.99,6.25,50,3.49
"3242",3242,"SEASON OF MYSTERY: The Cherry Blossom Murders",44000,51000,7000,4.99,15.91,50,2.49
"3243",3243,"Claire",46000,51000,5000,9.99,10.87,80,1.99
"3244",3244,"The Political Machine 2016",49000,51000,2000,9.99,4.08,50,4.99
"3245",3245,"What The Heck, Dude?",40000,51000,11000,0.99,27.5,51,0.49
"3246",3246,"Cannon Brawl",36000,51000,15000,14.99,41.67,75,3.74
"3247",3247,"Hentai Girl Betty",0,51000,51000,0.99,0,40,0.59
"3248",3248,"Marble Age",48000,51000,3000,5.99,6.25,60,2.39
"3249",3249,"Rush for gold: Alaska",38000,51000,13000,3.99,34.21,50,1.99
"3250",3250,"Lightblade VR",47000,51000,4000,3.99,8.51,0,3.99
"3251",3251,"'n Verlore Verstand",39000,51000,12000,14.99,30.77,80,2.99
"3252",3252,"Return to Mysterious Island",49000,51000,2000,7.99,4.08,75,1.99
"3253",3253,"Dark Void",44000,51000,7000,9.99,15.91,80,1.99
"3254",3254,"Kitchen Simulator 2015",43000,51000,8000,0.99,18.6,51,0.49
"3255",3255,"BlazBlue: Cross Tag Battle",28000,51000,23000,49.99,82.14,25,37.49
"3256",3256,"Rogue Port - Red Nightmare",48000,51000,3000,0.99,6.25,25,0.74
"3257",3257,"Bubble Blowout",43000,51000,8000,0.99,18.6,75,0.49
"3258",3258,"Eastwood VR",47000,51000,4000,3.99,8.51,0,3.99
"3259",3259,"Interplanetary: Enhanced Edition",11000,51000,40000,14.99,363.64,75,3.74
"3260",3260,"Conflict Desert Storm",46000,51000,5000,6.99,10.87,86,0.97
"3261",3261,"Collisions",39000,51000,12000,3.99,30.77,50,1.99
"3262",3262,"The Secret Order 2: Masked Intent",45000,50000,5000,9.99,11.11,70,2.99
"3263",3263,"Midnight Mysteries: Salem Witch Trials",48000,50000,2000,9.99,4.17,60,3.99
"3264",3264,"DUSK",28000,50000,22000,20,78.57,17,16.66
"3265",3265,"Full Bore",47000,50000,3000,14.99,6.38,75,3.74
"3266",3266,"War in a Box: Paper Tanks",48000,50000,2000,4.99,4.17,55,2.24
"3267",3267,"Xeodrifter",46000,50000,4000,9.99,8.7,90,0.99
"3268",3268,"Real Warfare 2: Northern Crusades",47000,50000,3000,4.99,6.38,75,1.24
"3269",3269,"Ember",46000,50000,4000,9.99,8.7,75,2.49
"3270",3270,"Alien Hallway",48000,50000,2000,4.99,4.17,90,0.49
"3271",3271,"Megaton Rainfall",20000,50000,30000,15.99,150,50,7.99
"3272",3272,"RaidersSphere4th",25000,50000,25000,19.99,100,75,4.99
"3273",3273,"9 Clues 2: The Ward",47000,50000,3000,9.99,6.38,70,2.99
"3274",3274,"Artillerists",7000,50000,43000,3.99,614.29,40,2.39
"3275",3275,"Moorhuhn (Crazy Chicken)",30000,50000,20000,1.99,66.67,50,0.99
"3276",3276,"Death's Hangover",40000,50000,10000,4.99,25,90,0.49
"3277",3277,"Xbird",39000,50000,11000,0.99,28.21,37,0.62
"3278",3278,"Outcast 1.1",45000,50000,5000,5.99,11.11,70,1.79
"3279",3279,"Kingdoms Rise",45000,50000,5000,14.99,11.11,0,14.99
"3280",3280,"Air Guardians",47000,50000,3000,0.99,6.38,0,0.99
"3281",3281,"Mystic Saga",40000,50000,10000,4.99,25,90,0.49
"3282",3282,"iO",41000,50000,9000,4.99,21.95,80,0.99
"3283",3283,"Spaera",41000,50000,9000,9.99,21.95,0,9.99
"3284",3284,"River City Super Sports Challenge ~All Stars Special~",32000,50000,18000,19.99,56.25,85,2.99
"3285",3285,"Foto Flash",11000,50000,39000,2.99,354.55,50,1.49
"3286",3286,"DOOM VFR",35000,49000,14000,29.99,40,50,14.99
"3287",3287,"Pixel Privateers",37000,49000,12000,14.99,32.43,0,14.99
"3288",3288,"Nimble Quest",41000,49000,8000,4.99,19.51,0,4.99
"3289",3289,"Obscure II (Obscure: The Aftermath)",42000,49000,7000,9.99,16.67,50,4.99
"3290",3290,"Into the Dark: Ultimate Trash Edition",47000,49000,2000,4.99,4.26,50,3.84
"3291",3291,"Survival Is Not Enough",44000,49000,5000,4.99,11.36,50,2.49
"3292",3292,"Sid Meier's Colonization (Classic)",47000,49000,2000,6.99,4.26,70,2.09
"3293",3293,"SPACEPLAN",40000,49000,9000,2.99,22.5,50,1.49
"3294",3294,"Mythic Wonders: The Philosopher's Stone",31000,49000,18000,9.99,58.06,70,2.99
"3295",3295,"Orbit HD",47000,49000,2000,1.99,4.26,30,0.69
"3296",3296,"Choice of Robots",45000,49000,4000,5.99,8.89,35,3.89
"3297",3297,"The Underground Man",30000,49000,19000,1.99,63.33,75,0.49
"3298",3298,"Word Killer: Zorgilonian Chronicles",38000,49000,11000,1.99,28.95,75,0.49
"3299",3299,"Immersion",11000,49000,38000,9.99,345.45,90,0.99
"3300",3300,"U L T R A _ H A R D C O R E",19000,49000,30000,0.99,157.89,10,0.89
"3301",3301,"CreaVures",47000,49000,2000,4.99,4.26,90,0.49
"3302",3302,"The Inevitability",39000,49000,10000,0.99,25.64,45,0.54
"3303",3303,"Dreamscapes: The Sandman - Premium Edition",42000,49000,7000,6.99,16.67,80,1.39
"3304",3304,"Where are my Internets?",10000,49000,39000,2.99,390,75,0.74
"3305",3305,"Tales Across Time",37000,49000,12000,2.99,32.43,20,2.39
"3306",3306,"Nevermind",27000,49000,22000,19.99,81.48,75,4.99
"3307",3307,"Harvester",46000,49000,3000,5.99,6.52,80,1.19
"3308",3308,"Pitiri 1977",39000,49000,10000,3.99,25.64,77,0.91
"3309",3309,"Downfall",23000,49000,26000,10.99,113.04,75,2.74
"3310",3310,"Eleven: Table Tennis VR",42000,48000,6000,19.99,14.29,50,9.99
"3311",3311,"X-Morph: Defense",25000,48000,23000,19.99,92,60,7.99
"3312",3312,"Strategy & Tactics: Wargame Collection",37000,48000,11000,9.99,29.73,75,2.49
"3313",3313,"Rubber and Lead",41000,48000,7000,4.99,17.07,0,4.99
"3314",3314,"Cooking Witch",25000,48000,23000,1.99,92,75,0.49
"3315",3315,"KAMUI",40000,48000,8000,7.99,20,50,3.99
"3316",3316,"Alone in the Dark",46000,48000,2000,9.99,4.35,75,2.49
"3317",3317,"Intake",38000,48000,10000,9.99,26.32,0,9.99
"3318",3318,"Eventide Night",44000,48000,4000,1.99,9.09,50,0.99
"3319",3319,"Ludo Supremo",36000,48000,12000,1.99,33.33,80,0.49
"3320",3320,"Depths of Peril",43000,48000,5000,9.99,11.63,80,1.99
"3321",3321,"Toukiden: Kiwami",26000,48000,22000,59.99,84.62,50,29.99
"3322",3322,"Agricultural Simulator 2011: Extended Edition",42000,48000,6000,2.99,14.29,80,0.59
"3323",3323,"Fall of the New Age Premium Edition",37000,48000,11000,6.99,29.73,80,1.39
"3324",3324,"Warhammer 40,000: Armageddon",45000,48000,3000,39.99,6.67,76,9.59
"3325",3325,"The Last Error",45000,48000,3000,1.99,6.67,75,0.49
"3326",3326,"ARMA: Combat Operations",45000,48000,3000,7.99,6.67,80,1.59
"3327",3327,"Hyperspace Invaders II: Pixel Edition",38000,48000,10000,4.99,26.32,90,0.49
"3328",3328,"Do Not Feed the Monkeys",0,48000,48000,11.99,0,20,9.59
"3329",3329,"Planet Nomads",41000,48000,7000,19.99,17.07,50,9.99
"3330",3330,"TAP TOUCH RUN",45000,48000,3000,0.99,6.67,51,0.49
"3331",3331,"VoidExpanse",45000,48000,3000,14.99,6.67,60,5.99
"3332",3332,"Hyperdrive Massacre",2000,48000,46000,9.99,2300,90,0.99
"3333",3333,"Old Man's Journey",16000,48000,32000,7.99,200,75,1.99
"3334",3334,"Time in Time",45000,48000,3000,1.99,6.67,75,0.49
"3335",3335,"Last Dream",45000,48000,3000,9.99,6.67,80,1.99
"3336",3336,"Usotsuki Game / 谎言游戏",16000,48000,32000,1.99,200,60,0.79
"3337",3337,"World Ship Simulator",45000,48000,3000,19.99,6.67,75,4.99
"3338",3338,"Stonerid",42000,48000,6000,4.99,14.29,90,0.49
"3339",3339,"Candle",39000,48000,9000,14.99,23.08,70,4.49
"3340",3340,"Ostalgie: The Berlin Wall",9000,48000,39000,5.99,433.33,25,4.49
"3341",3341,"STAR OCEAN - THE LAST HOPE - 4K & Full HD Remaster",37000,48000,11000,20.99,29.73,50,10.49
"3342",3342,"Tungulus",42000,48000,6000,1.99,14.29,0,1.99
"3343",3343,"Envoy 2",45000,48000,3000,0.99,6.67,51,0.49
"3344",3344,"Hard Truck Apocalypse: Rise Of Clans / Ex Machina: Meridian 113",43000,48000,5000,5.99,11.63,90,0.59
"3345",3345,"Stones of Sorrow",40000,48000,8000,2.99,20,83,0.5
"3346",3346,"Mata Hari",41000,48000,7000,9.99,17.07,75,2.49
"3347",3347,"Kult: Heretic Kingdoms",37000,48000,11000,4.99,29.73,80,0.99
"3348",3348,"Super Seducer : How to Talk to Girls",21000,48000,27000,12.99,128.57,36,8.31
"3349",3349,"Duke Nukem 3D: 20th Anniversary World Tour",39000,48000,9000,19.99,23.08,75,4.99
"3350",3350,"Pure Farming 2018",26000,48000,22000,19.99,84.62,60,7.99
"3351",3351,"Zup! 8",27000,48000,21000,0.99,77.78,30,0.69
"3352",3352,"Aven Colony",35000,47000,12000,29.99,34.29,75,7.49
"3353",3353,"Mega Man 11 / ロックマン11 運命の歯車!!",0,47000,47000,29.99,0,20,23.99
"3354",3354,"Seven Kingdoms 2 HD",42000,47000,5000,9.99,11.9,60,3.99
"3355",3355,"Dungeon Lords Steam Edition",26000,47000,21000,14.99,80.77,75,3.74
"3356",3356,"Sea Legends: Phantasmal Light Collector's Edition",40000,47000,7000,4.99,17.5,80,0.99
"3357",3357,"Alien Spidy",41000,47000,6000,9.99,14.63,90,0.99
"3358",3358,"Terrian Saga: KR-17",40000,47000,7000,4.99,17.5,90,0.49
"3359",3359,"Mad Muzzles",41000,47000,6000,0.99,14.63,51,0.49
"3360",3360,"Hare In The Hat",44000,47000,3000,1.99,6.82,70,0.59
"3361",3361,"Armada 2526 Gold Edition",44000,47000,3000,19.99,6.82,85,2.99
"3362",3362,"DARTHY",42000,47000,5000,0.99,11.9,0,0.99
"3363",3363,"The Black Death",37000,47000,10000,19.99,27.03,50,9.99
"3364",3364,"Victory At Sea",43000,47000,4000,24.99,9.3,80,4.99
"3365",3365,"Blueberry Garden",45000,47000,2000,4.99,4.44,80,0.99
"3366",3366,"Zenith",13000,47000,34000,14.99,261.54,60,5.99
"3367",3367,"Rozkol",36000,47000,11000,2.99,30.56,83,0.5
"3368",3368,"BIT.TRIP FATE",41000,47000,6000,9.99,14.63,90,0.99
"3369",3369,"ASMR Universe",45000,47000,2000,2.99,4.44,0,2.99
"3370",3370,"Yomawari: Night Alone / 夜廻",39000,47000,8000,19.99,20.51,75,4.99
"3371",3371,"Planet Centauri",33000,47000,14000,14.99,42.42,10,13.49
"3372",3372,"The Repopulation",37000,47000,10000,19.99,27.03,0,19.99
"3373",3373,"Magicmaker",31000,47000,16000,9.99,51.61,75,2.49
"3374",3374,"Vegas: Make It Big",45000,47000,2000,4.99,4.44,90,0.49
"3375",3375,"Stay Alight",24000,47000,23000,3.99,95.83,0,3.99
"3376",3376,"Corrosion: Cold Winter Waiting [Enhanced Edition]",35000,47000,12000,7.99,34.29,90,0.79
"3377",3377,"NEKOPARA Extra",0,47000,47000,4.99,0,10,4.49
"3378",3378,"Predynastic Egypt",42000,47000,5000,9.99,11.9,60,3.99
"3379",3379,"The Legend of Heroes: Trails in the Sky SC",44000,47000,3000,29.99,6.82,35,19.49
"3380",3380,"Abyss Raiders: Uncharted",44000,47000,3000,4.99,6.82,90,0.49
"3381",3381,"FRACT OSC",43000,47000,4000,14.99,9.3,0,14.99
"3382",3382,"Heavy Fire: Afghanistan",33000,47000,14000,2.99,42.42,67,0.98
"3383",3383,"Surfasaurus",37000,47000,10000,0.99,27.03,25,0.74
"3384",3384,"7,62 Hard Life",31000,47000,16000,4.99,51.61,80,0.99
"3385",3385,"Immortal Heroes",28000,47000,19000,0.99,67.86,30,0.69
"3386",3386,"WolfQuest",35000,47000,12000,9.99,34.29,0,9.99
"3387",3387,"Sticker Craft",44000,46000,2000,0.99,4.55,51,0.49
"3388",3388,"Mob Rule Classic",28000,46000,18000,5.99,64.29,75,1.49
"3389",3389,"Will To Live Online",20000,46000,26000,11.99,130,50,7.49
"3390",3390,"CUBOTS The Origins",40000,46000,6000,2.99,15,65,1.04
"3391",3391,"Succubus Rem",37000,46000,9000,1.99,24.32,70,0.59
"3392",3392,"TransOcean 2: Rivals",36000,46000,10000,24.99,27.78,60,9.99
"3393",3393,"Gladiator Trainer",42000,46000,4000,1.99,9.52,75,0.49
"3394",3394,"The Samaritan Paradox",37000,46000,9000,6.99,24.32,76,1.67
"3395",3395,"Battlevoid: Harbinger",37000,46000,9000,9.99,24.32,90,0.99
"3396",3396,"Cannons-Defenders: Steam Edition",38000,46000,8000,0.99,21.05,51,0.49
"3397",3397,"Paranormal",38000,46000,8000,9.99,21.05,25,7.49
"3398",3398,"Iron Sea Defenders",33000,46000,13000,4.99,39.39,90,0.49
"3399",3399,"LOR - League of Runners",28000,46000,18000,4.99,64.29,33,3.34
"3400",3400,"Microcosmum: survival of cells",35000,46000,11000,7.99,31.43,70,2.39
"3401",3401,"RC Cars",43000,46000,3000,2.99,6.98,75,0.74
"3402",3402,"7 Wonders: Ancient Alien Makeover",43000,46000,3000,9.99,6.98,60,3.99
"3403",3403,"Live2DViewerEX",34000,46000,12000,4.99,35.29,0,4.99
"3404",3404,"Airport Madness: World Edition",33000,46000,13000,9.99,39.39,50,4.99
"3405",3405,"Bad Dream: Coma",26000,46000,20000,8.99,76.92,90,0.89
"3406",3406,"Space Colony: Steam Edition",30000,46000,16000,14.99,53.33,80,2.99
"3407",3407,"eSports Legend / 电竞传奇",0,46000,46000,9.99,0,22,7.79
"3408",3408,"Orbox C",39000,46000,7000,2.99,17.95,0,2.99
"3409",3409,"Reptilian Rebellion",34000,45000,11000,0.99,32.35,51,0.49
"3410",3410,"The Mercury Man",12000,45000,33000,3.99,275,0,3.99
"3411",3411,"The Drone Racing League Simulator",30000,45000,15000,19.99,50,0,19.99
"3412",3412,"Rise of Industry",17000,45000,28000,24.99,164.71,33,16.74
"3413",3413,"Discord Bot Maker",8000,45000,37000,9.99,462.5,0,9.99
"3414",3414,"Quadrilateral Cowboy",26000,45000,19000,19.99,73.08,66,6.79
"3415",3415,"Alice's Patchworks 2",36000,45000,9000,4.99,25,90,0.49
"3416",3416,"Dragon's Lair",32000,45000,13000,9.99,40.63,50,4.99
"3417",3417,"Conquest of Elysium 3",41000,45000,4000,9.99,9.76,75,2.49
"3418",3418,"Shiny The Firefly",32000,45000,13000,9.99,40.63,90,0.99
"3419",3419,"Vive le Roi",32000,45000,13000,3.99,40.63,70,0.89
"3420",3420,"Stormworks: Build and Rescue",19000,45000,26000,14.99,136.84,0,14.99
"3421",3421,"Ballistic Attack",40000,45000,5000,0.99,12.5,51,0.49
"3422",3422,"1979 Revolution: Black Friday",31000,45000,14000,5.99,45.16,75,1.49
"3423",3423,"Asdivine Hearts",43000,45000,2000,9.99,4.65,50,4.99
"3424",3424,"Onion Force",32000,45000,13000,4.99,40.63,60,1.99
"3425",3425,"Sokobond",38000,45000,7000,9.99,18.42,70,2.99
"3426",3426,"Fly in the House",41000,45000,4000,9.99,9.76,85,1.49
"3427",3427,"White Day: A Labyrinth Named School",11000,45000,34000,29.99,309.09,75,7.49
"3428",3428,"Swarmlake",29000,45000,16000,2.99,55.17,67,0.49
"3429",3429,"24 Hours 'til Rescue",42000,45000,3000,3.99,7.14,66,1.35
"3430",3430,"Zoombinis",41000,45000,4000,9.99,9.76,75,2.49
"3431",3431,"Strategy & Tactics: Dark Ages",40000,45000,5000,14.99,12.5,60,5.99
"3432",3432,"Hustle Cat",35000,45000,10000,19.99,28.57,60,7.99
"3433",3433,"Fox Hime Zero",18000,45000,27000,1.99,150,50,0.99
"3434",3434,"Sky Mercenaries",36000,45000,9000,9.99,25,85,1.49
"3435",3435,"Battle Chef Brigade Deluxe",17000,45000,28000,19.99,164.71,40,11.99
"3436",3436,"Tank Destroyer",37000,45000,8000,2.99,21.62,83,0.5
"3437",3437,"Last Days of Spring Visual Novel",37000,45000,8000,2.99,21.62,66,1.01
"3438",3438,"Valkyria Chronicles 4",0,45000,45000,59.99,0,50,29.99
"3439",3439,"Dark Project",38000,45000,7000,4.99,18.42,80,0.99
"3440",3440,"Skyshine's BEDLAM",41000,45000,4000,19.99,9.76,75,4.99
"3441",3441,"ClickRaid",28000,45000,17000,4.99,60.71,50,2.49
"3442",3442,"Pandora: First Contact",43000,45000,2000,29.99,4.65,75,7.49
"3443",3443,"Shadows of War",37000,45000,8000,2.99,21.62,80,0.59
"3444",3444,"Dracula 3: The Path of the Dragon",42000,45000,3000,7.99,7.14,70,2.39
"3445",3445,"Hyper Knights",20000,45000,25000,4.99,125,50,2.49
"3446",3446,"Slayaway Camp",43000,45000,2000,8.99,4.65,80,0.49
"3447",3447,"World War I",41000,44000,3000,4.99,7.32,80,0.99
"3448",3448,"Moto Racer Collection",35000,44000,9000,9.99,25.71,70,2.99
"3449",3449,"HELLGATE: London",0,44000,44000,12.99,0,25,9.74
"3450",3450,"NeuroVoider",20000,44000,24000,13.99,120,65,4.89
"3451",3451,"Belladonna",41000,44000,3000,6.99,7.32,90,0.69
"3452",3452,"7 Wonders II",42000,44000,2000,9.99,4.76,60,3.99
"3453",3453,"Psycho on the loose",41000,44000,3000,1.99,7.32,51,0.49
"3454",3454,"Point Perfect",39000,44000,5000,4.99,12.82,80,0.99
"3455",3455,"Everyday Shooter",41000,44000,3000,9.99,7.32,0,9.99
"3456",3456,"Morningstar: Descent to Deadrock",38000,44000,6000,9.99,15.79,75,2.49
"3457",3457,"Qbeh-1: The Atlas Cube",42000,44000,2000,9.99,4.76,90,0.99
"3458",3458,"Waddle Home",30000,44000,14000,9.99,46.67,75,2.49
"3459",3459,"Metal Drift",42000,44000,2000,9.99,4.76,50,4.99
"3460",3460,"Ara Fell",39000,44000,5000,9.99,12.82,65,3.49
"3461",3461,"Project Temporality",42000,44000,2000,14.99,4.76,80,2.99
"3462",3462,"Project Tarvotan",36000,44000,8000,1.99,22.22,75,0.49
"3463",3463,"Bonsai",35000,44000,9000,0.99,25.71,51,0.49
"3464",3464,"The Last Leviathan",38000,44000,6000,9.99,15.79,33,6.69
"3465",3465,"Richie's Plank Experience",36000,44000,8000,14.99,22.22,0,14.99
"3466",3466,"The Golf Club 2",18000,44000,26000,39.99,144.44,80,7.99
"3467",3467,"Incandescent",30000,44000,14000,0.99,46.67,51,0.49
"3468",3468,"Mall Empire",3000,44000,41000,3.99,1366.67,87,0.51
"3469",3469,"Strategic War in Europe",33000,44000,11000,14.99,33.33,85,2.24
"3470",3470,"BalanCity",30000,44000,14000,7.99,46.67,90,0.79
"3471",3471,"Joint Task Force",42000,44000,2000,4.99,4.76,75,2.49
"3472",3472,"Death Track: Resurrection",42000,44000,2000,2.99,4.76,77,0.68
"3473",3473,"Darkarta: A Broken Heart's Quest Collector's Edition",25000,44000,19000,9.99,76,75,1.49
"3474",3474,"InFlux",40000,44000,4000,9.99,10,50,4.99
"3475",3475,"Sacra Terra: Angelic Night",33000,44000,11000,2.99,33.33,70,0.89
"3476",3476,"Blues and Bullets",39000,44000,5000,4.99,12.82,0,4.99
"3477",3477,"Running Through Russia",30000,43000,13000,0.99,43.33,33,0.66
"3478",3478,"Sinking Island",41000,43000,2000,7.99,4.88,75,1.99
"3479",3479,"Dungeon Warfare 2",0,43000,43000,14.99,0,20,11.99
"3480",3480,"0RBITALIS",41000,43000,2000,9.99,4.88,80,1.99
"3481",3481,"The Golf Club",41000,43000,2000,29.99,4.88,0,29.99
"3482",3482,"Xpand Rally",41000,43000,2000,4.99,4.88,80,0.99
"3483",3483,"Bejeweled Twist",38000,43000,5000,4.99,13.16,75,1.24
"3484",3484,"INSOMNIA: The Ark",0,43000,43000,29.99,0,10,26.99
"3485",3485,"Dead Effect 2 VR",27000,43000,16000,24.99,59.26,70,7.49
"3486",3486,"Commander Cool 2",23000,43000,20000,2.99,86.96,71,0.86
"3487",3487,"Beach Bounce",38000,43000,5000,9.99,13.16,60,3.99
"3488",3488,"Heavy Weapon Deluxe",40000,43000,3000,4.99,7.5,75,1.24
"3489",3489,"AMID EVIL",10000,43000,33000,20,330,14,17.2
"3490",3490,"King of Dragon Pass",29000,43000,14000,11.99,48.28,70,3.59
"3491",3491,"Azure Striker Gunvolt",39000,43000,4000,14.99,10.26,75,3.74
"3492",3492,"Above - VR",33000,43000,10000,3.99,30.3,75,0.99
"3493",3493,"Magicka: Wizards of the Square Tablet",41000,43000,2000,4.99,4.88,50,2.49
"3494",3494,"Pier Solar and the Great Architects",38000,43000,5000,14.99,13.16,0,14.99
"3495",3495,"VEGAS Movie Studio 13 Platinum - Steam Powered",40000,43000,3000,44.99,7.5,70,17.99
"3496",3496,"Pale Echoes",36000,43000,7000,4.99,19.44,75,1.24
"3497",3497,"Danmaku Unlimited 2",41000,43000,2000,4.99,4.88,80,0.99
"3498",3498,"Linelight",14000,43000,29000,9.99,207.14,60,3.99
"3499",3499,"Doodle Kingdom",39000,43000,4000,8.99,10.26,71,2.6
"3500",3500,"Abrix for kids",40000,43000,3000,4.99,7.5,90,0.49
"3501",3501,"HALUNAZI",40000,43000,3000,0.99,7.5,51,0.49
"3502",3502,"Tiki Man",40000,43000,3000,0.99,7.5,49,0.5
"3503",3503,"Witch's Pranks: Frog's Fortune Collector's Edition",38000,43000,5000,6.99,13.16,80,1.39
"3504",3504,"Keebles",27000,43000,16000,9.99,59.26,90,0.99
"3505",3505,"Subsurface Circular",21000,43000,22000,5.99,104.76,20,4.79
"3506",3506,"Nobunaga's Ambition: Taishi / 信長の野望･大志",31000,43000,12000,59.99,38.71,30,41.99
"3507",3507,"Graviteam Tactics: Operation Star",41000,43000,2000,29.99,4.88,50,14.99
"3508",3508,"hocus",39000,43000,4000,0.99,10.26,51,0.49
"3509",3509,"El Matador",41000,43000,2000,3.99,4.88,80,0.79
"3510",3510,"My Own Little Planet",37000,43000,6000,5.99,16.22,75,1.49
"3511",3511,"Full Metal Furies",24000,43000,19000,19.99,79.17,50,9.99
"3512",3512,"Otaku's Fantasy 2",18000,43000,25000,1.99,138.89,60,0.79
"3513",3513,"Sherlock Holmes and The Hound of The Baskervilles",41000,43000,2000,9.99,4.88,75,2.49
"3514",3514,"Autobahn Police Simulator",38000,42000,4000,9.99,10.53,55,4.49
"3515",3515,"Dungeon Escape",31000,42000,11000,3.99,35.48,88,0.49
"3516",3516,"Tick Tock Isle",39000,42000,3000,0.99,7.69,51,0.49
"3517",3517,"Samantha Swift and the Hidden Roses of Athena",40000,42000,2000,9.99,5,60,3.99
"3518",3518,"UNLOVED",27000,42000,15000,9.99,55.56,80,1.99
"3519",3519,"Battle Royale: Survivors",0,42000,42000,4.99,0,40,2.99
"3520",3520,"Samantha Swift and the Golden Touch",39000,42000,3000,9.99,7.69,60,3.99
"3521",3521,"Atlantic Fleet",40000,42000,2000,9.99,5,30,6.99
"3522",3522,"Puzzle Cube",36000,42000,6000,2.99,16.67,10,2.69
"3523",3523,"Kio's Adventure",32000,42000,10000,1.99,31.25,50,0.99
"3524",3524,"Panzer Elite Action Gold Edition",39000,42000,3000,9.99,7.69,75,2.49
"3525",3525,"Pixel Puzzles 2: RADical ROACH",38000,42000,4000,9.99,10.53,80,1.99
"3526",3526,"Magrunner: Dark Pulse",39000,42000,3000,9.99,7.69,75,2.49
"3527",3527,"Miner Ultra Adventures",39000,42000,3000,0.99,7.69,25,0.74
"3528",3528,"Bloody Boobs",40000,42000,2000,2.99,5,83,0.5
"3529",3529,"Square Heroes",37000,42000,5000,4.99,13.51,60,1.99
"3530",3530,"Mr. Robot",37000,42000,5000,7.99,13.51,75,1.99
"3531",3531,"Dusk 12",39000,42000,3000,3.99,7.69,88,0.49
"3532",3532,"Warhammer 40,000: Space Wolf",39000,42000,3000,17.99,7.69,50,8.99
"3533",3533,"NEO AQUARIUM - The King of Crustaceans -",40000,42000,2000,8.99,5,70,2.69
"3534",3534,"Codename: Panzers - Cold War",40000,42000,2000,14.99,5,75,3.74
"3535",3535,"Clandestinity of Elsie",40000,42000,2000,4.99,5,90,0.49
"3536",3536,"Radical Dungeon Sweeper",21000,42000,21000,12.99,100,0,12.99
"3537",3537,"Tulpa",36000,42000,6000,9.99,16.67,80,1.99
"3538",3538,"The Quest for Achievements II",31000,42000,11000,4.99,35.48,80,0.99
"3539",3539,"The Secret Order 3: Ancient Times",26000,42000,16000,9.99,61.54,70,2.99
"3540",3540,"Battlezone 98 Redux",33000,42000,9000,19.99,27.27,75,4.99
"3541",3541,"Watchmen: The End is Nigh",33000,42000,9000,4.99,27.27,0,4.99
"3542",3542,"A-Gents",27000,42000,15000,4.99,55.56,50,2.49
"3543",3543,"Warhammer 40,000: Mechanicus",0,42000,42000,29.99,0,10,26.99
"3544",3544,"Leap Up no jutsu",38000,42000,4000,0.99,10.53,51,0.49
"3545",3545,"Angry Birds Space",37000,42000,5000,4.99,13.51,0,4.99
"3546",3546,"Sos i Pie Sos",26000,42000,16000,0.99,61.54,51,0.49
"3547",3547,"東方天空璋 ～ Hidden Star in Four Seasons.",35000,42000,7000,14.99,20,0,14.99
"3548",3548,"Escape Goat",28000,42000,14000,4.99,50,90,0.49
"3549",3549,"Wildlife Park 2 - Dino World",29000,42000,13000,3.99,44.83,33,2.67
"3550",3550,"TRAPPED",3000,42000,39000,24.99,1300,50,12.49
"3551",3551,"Kingdom Rush Origins",0,42000,42000,14.99,0,15,12.74
"3552",3552,"Verdict Guilty - 유죄 평결",31000,42000,11000,4.99,35.48,90,0.49
"3553",3553,"Townopolis",29000,42000,13000,3.99,44.83,75,0.99
"3554",3554,"Dead In Bermuda",40000,42000,2000,14.99,5,70,4.49
"3555",3555,"Stranded",24000,42000,18000,0.99,75,40,0.59
"3556",3556,"Luxor HD",28000,41000,13000,9.99,46.43,60,3.99
"3557",3557,"FORCED SHOWDOWN",34000,41000,7000,19.99,20.59,70,5.99
"3558",3558,"Through the Woods",20000,41000,21000,19.99,105,80,3.99
"3559",3559,"Black Sails - The Ghost Ship",38000,41000,3000,9.99,7.89,87,1.29
"3560",3560,"Video blogger Story",31000,41000,10000,6.99,32.26,30,4.89
"3561",3561,"Mystic Towers",31000,41000,10000,4.99,32.26,50,2.49
"3562",3562,"Apocalypse Hotel - The Post-Apocalyptic Hotel Simulator!",28000,41000,13000,6.99,46.43,70,2.09
"3563",3563,"Novus Inceptio",33000,41000,8000,19.99,24.24,60,7.99
"3564",3564,"SUDOKU",34000,41000,7000,0.99,20.59,51,0.49
"3565",3565,"Unrest",35000,41000,6000,9.99,17.14,90,1.49
"3566",3566,"Super Cyborg",37000,41000,4000,4.99,10.81,65,1.74
"3567",3567,"Ruthless Safari",13000,41000,28000,0.99,215.38,51,0.49
"3568",3568,"Danganronpa Another Episode: Ultra Despair Girls",33000,41000,8000,29.99,24.24,50,14.99
"3569",3569,"NEKO-NIN exHeart",31000,41000,10000,9.99,32.26,50,4.99
"3570",3570,"Taima Miko Yuugi",33000,41000,8000,1.99,24.24,70,0.59
"3571",3571,"Zombie Vikings",36000,41000,5000,11.99,13.89,75,2.99
"3572",3572,"BERSERK and the Band of the Hawk",39000,41000,2000,59.99,5.13,50,29.99
"3573",3573,"Boundless",17000,41000,24000,39.99,141.18,20,31.99
"3574",3574,"Helldorado",38000,41000,3000,9.99,7.89,75,2.49
"3575",3575,"Robot Shield",35000,41000,6000,1.99,17.14,75,0.49
"3576",3576,"Defense Of Greece TD",33000,41000,8000,5.99,24.24,50,2.99
"3577",3577,"Crazy Plant Shop",39000,41000,2000,4.99,5.13,50,2.49
"3578",3578,"Yumsters 2: Around the World",38000,41000,3000,4.99,7.89,0,4.99
"3579",3579,"The Defenders: The Second Wave",38000,41000,3000,2.99,7.89,75,0.74
"3580",3580,"Flashing Lights - Police Fire EMS",18000,41000,23000,14.99,127.78,20,11.99
"3581",3581,"Space Fuss",38000,41000,3000,4.99,7.89,90,0.49
"3582",3582,"Word Killer: Revolution",38000,41000,3000,1.99,7.89,75,0.49
"3583",3583,"Voyage: Journey to the Moon",30000,41000,11000,4.99,36.67,60,1.99
"3584",3584,"Mobile Empire",38000,41000,3000,9.99,7.89,30,6.99
"3585",3585,"Spirits of Xanadu",29000,41000,12000,4.99,41.38,83,0.84
"3586",3586,"Dark Heritage: Guardians of Hope",29000,41000,12000,9.99,41.38,70,2.99
"3587",3587,"Dungeon Rushers: Crawler RPG",31000,41000,10000,14.99,32.26,75,3.74
"3588",3588,"The Wizard's Lair",31000,41000,10000,2.99,32.26,75,0.74
"3589",3589,"BlackFaith",0,41000,41000,4.99,0,0,4.99
"3590",3590,"Depths of Fear :: Knossos",39000,41000,2000,5.99,5.13,90,0.59
"3591",3591,"Space Impact Glitch",30000,41000,11000,2.99,36.67,83,0.5
"3592",3592,"Campfire: One of Us Is the Killer",32000,40000,8000,2.99,25,0,2.99
"3593",3593,"Hidden Object Bundle 4 in 1",30000,40000,10000,7.99,33.33,75,1.99
"3594",3594,"Pummel Party",0,40000,40000,14.99,0,10,13.49
"3595",3595,"Kaptain Brawe: A Brawe New World",38000,40000,2000,4.99,5.26,75,1.24
"3596",3596,"Broccoli Bob",32000,40000,8000,0.99,25,51,0.49
"3597",3597,"Realms of Arkania 1 - Blade of Destiny Classic",31000,40000,9000,3.99,29.03,75,0.99
"3598",3598,"Pristine world",38000,40000,2000,4.99,5.26,90,0.49
"3599",3599,"The Few",36000,40000,4000,7.99,11.11,75,1.99
"3600",3600,"Hiveswap Friendsim",24000,40000,16000,0.99,66.67,51,0.49
"3601",3601,"Alter Ego",33000,40000,7000,9.99,21.21,50,4.99
"3602",3602,"Antihero",30000,40000,10000,14.99,33.33,67,4.94
"3603",3603,"MURI",36000,40000,4000,4.99,11.11,87,0.51
"3604",3604,"Dragon Kingdom War",32000,40000,8000,4.99,25,30,3.49
"3605",3605,"On the front line",38000,40000,2000,7.99,5.26,10,4.49
"3606",3606,"Blackwell Epiphany",28000,40000,12000,9.99,42.86,80,1.99
"3607",3607,"Need For Drink",38000,40000,2000,1.99,5.26,33,1.33
"3608",3608,"Hired Ops",28000,40000,12000,9.99,42.86,0,9.99
"3609",3609,"Wings! Remastered Edition",37000,40000,3000,14.99,8.11,80,2.99
"3610",3610,"7 Wonders: Treasures of Seven",36000,40000,4000,9.99,11.11,60,3.99
"3611",3611,"Action! - Gameplay Recording and Streaming",35000,40000,5000,49.99,14.29,50,24.99
"3612",3612,"Ultimate Fishing Simulator",14000,40000,26000,19.99,185.71,33,13.39
"3613",3613,"IGT Slots Paradise Garden",24000,40000,16000,19.99,66.67,50,9.99
"3614",3614,"Zero Reflex : Black Eye Edition",34000,40000,6000,3.99,17.65,75,0.99
"3615",3615,"The Legend of Heroes: Trails of Cold Steel II",22000,40000,18000,39.99,81.82,30,27.99
"3616",3616,"Adventure Rage",28000,40000,12000,0.99,42.86,51,0.49
"3617",3617,"Decent Icons",22000,40000,18000,2.99,81.82,33,2
"3618",3618,"Toukiden 2",30000,40000,10000,59.99,33.33,50,29.99
"3619",3619,"Void Invaders",38000,40000,2000,2.99,5.26,83,0.5
"3620",3620,"WRC 6 FIA World Rally Championship",34000,40000,6000,44.99,17.65,80,8.99
"3621",3621,"Darkness Within 2: The Dark Lineage",35000,40000,5000,9.99,14.29,82,1.79
"3622",3622,"Wrath of Anna",22000,40000,18000,19.99,81.82,75,4.99
"3623",3623,"Barro",3000,40000,37000,0.99,1233.33,75,0.49
"3624",3624,"Just Shapes & Beats",10000,40000,30000,19.99,300,25,14.99
"3625",3625,"Children of the Nile: Alexandria",38000,40000,2000,2.49,5.26,0,2.49
"3626",3626,"50 years",21000,40000,19000,4.99,90.48,50,2.49
"3627",3627,"Freaking Meatbags",33000,40000,7000,9.99,21.21,80,1.99
"3628",3628,"NALOGI",22000,40000,18000,1.99,81.82,51,0.49
"3629",3629,"Putt-Putt Saves The Zoo",32000,40000,8000,6.99,25,60,2.79
"3630",3630,"Our Wonderful World",29000,40000,11000,0.99,37.93,30,0.69
"3631",3631,"Doom & Destiny",31000,40000,9000,9.99,29.03,50,4.99
"3632",3632,"R.O.O.T.S",38000,40000,2000,1.99,5.26,30,1.39
"3633",3633,"Supreme Ruler Ultimate",28000,39000,11000,19.99,39.29,60,7.99
"3634",3634,"Conarium",27000,39000,12000,19.99,44.44,66,6.79
"3635",3635,"Crimson Imprint plus -Nonexistent Christmas-",30000,39000,9000,1.99,30,60,0.79
"3636",3636,"Pillar",35000,39000,4000,7.99,11.43,90,0.79
"3637",3637,"RPG Tycoon",33000,39000,6000,9.99,18.18,50,4.99
"3638",3638,"Krautscape",33000,39000,6000,6.99,18.18,80,1.39
"3639",3639,"Last Horizon",16000,39000,23000,4.99,143.75,80,0.99
"3640",3640,"Nidhogg 2",26000,39000,13000,14.99,50,60,5.99
"3641",3641,"Chimpology",4000,39000,35000,1.99,875,75,0.49
"3642",3642,"Peace, Death!",35000,39000,4000,4.99,11.43,60,1.99
"3643",3643,"Iconoclasts",26000,39000,13000,19.99,50,25,14.99
"3644",3644,"Warhammer 40,000: Sanctus Reach",30000,39000,9000,29.99,30,67,9.89
"3645",3645,"Dynomite Deluxe",36000,39000,3000,4.99,8.33,75,1.24
"3646",3646,"That Dragon, Cancer",36000,39000,3000,9.99,8.33,40,5.99
"3647",3647,"Phantom Brave PC / ファントム・ブレイブ PC",28000,39000,11000,14.99,39.29,60,5.99
"3648",3648,"Metal Dead",37000,39000,2000,4.99,5.41,66,1.69
"3649",3649,"World of Diving",28000,39000,11000,19.99,39.29,90,1.99
"3650",3650,"BattleStorm",31000,39000,8000,2.99,25.81,67,0.98
"3651",3651,"Strike Suit Zero: Director's Cut",29000,39000,10000,19.99,34.48,80,3.99
"3652",3652,"Fairy Tale Mysteries: The Puppet Thief",37000,39000,2000,9.99,5.41,70,2.99
"3653",3653,"Rodina",33000,39000,6000,14.99,18.18,34,9.89
"3654",3654,"Artificial Defense",30000,39000,9000,2.99,30,70,0.89
"3655",3655,"Toby: The Secret Mine",36000,39000,3000,9.99,8.33,70,2.99
"3656",3656,"Alicemare",32000,39000,7000,2.99,21.88,40,1.79
"3657",3657,"Supercharged Robot VULKAISER",33000,39000,6000,4.99,18.18,50,2.49
"3658",3658,"Koala Kids",34000,39000,5000,1.99,14.71,60,0.49
"3659",3659,"Swordbreaker The Game",36000,39000,3000,2.99,8.33,45,1.64
"3660",3660,"Flow:The Sliding",29000,39000,10000,0.99,34.48,51,0.49
"3661",3661,"Recourse",24000,39000,15000,39.99,62.5,75,9.99
"3662",3662,"Burly Men at Sea",4000,39000,35000,9.99,875,60,3.99
"3663",3663,"Adventure Time: Magic Man's Head Games",3000,39000,36000,4.99,1200,40,2.99
"3664",3664,"War, the Game",36000,39000,3000,6.99,8.33,50,3.49
"3665",3665,"Picross Fairytale - nonogram: Red Riding Hood secret",0,39000,39000,4.99,0,90,0.49
"3666",3666,"Soundpad",18000,39000,21000,4.99,116.67,20,3.99
"3667",3667,"Delivery from the Pain",10000,39000,29000,7.99,290,30,5.59
"3668",3668,"Epic Battle Fantasy 5",0,39000,39000,14.99,0,0,14.99
"3669",3669,"Cannon Fodder 3",36000,39000,3000,14.99,8.33,60,5.99
"3670",3670,"Last Hope - Tower Defense",25000,39000,14000,8.99,56,75,2.24
"3671",3671,"Puzzle Quest: Galactrix",37000,39000,2000,9.99,5.41,0,9.99
"3672",3672,"Smugglers 5",35000,39000,4000,9.99,11.43,60,3.99
"3673",3673,"RESCUE 2: Everyday Heroes",21000,39000,18000,19.99,85.71,80,3.99
"3674",3674,"Chill the Piro",35000,39000,4000,1.99,11.43,50,0.99
"3675",3675,"KINGDOMS",31000,39000,8000,9.99,25.81,40,5.99
"3676",3676,"Investigator",29000,39000,10000,1.99,34.48,62,0.75
"3677",3677,"Shio",31000,39000,8000,11.99,25.81,50,5.99
"3678",3678,"Princess Evangile All Ages Version",25000,39000,14000,34.99,56,60,13.99
"3679",3679,"it's always monday",34000,39000,5000,0.99,14.71,0,0.99
"3680",3680,"Mahjong World Contest",34000,39000,5000,4.99,14.71,90,0.49
"3681",3681,"7 Wonders of the Ancient World",30000,39000,9000,6.99,30,60,2.79
"3682",3682,"SAMURAI WARRIORS 4-II",34000,39000,5000,49.99,14.71,50,24.99
"3683",3683,"The Legend of Heroes: Trails in the Sky the 3rd",20000,39000,19000,29.99,95,25,22.49
"3684",3684,"De-Void",26000,39000,13000,7.99,50,85,1.19
"3685",3685,"Dungeons: The Eye of Draconus",36000,39000,3000,2.99,8.33,75,0.74
"3686",3686,"QuiVr",29000,39000,10000,19.99,34.48,20,15.99
"3687",3687,"Quantum Rush Champions",31000,39000,8000,9.99,25.81,70,2.99
"3688",3688,"Radioactive Puzzle",22000,39000,17000,0.99,77.27,51,0.49
"3689",3689,"BATTLE PIXELS",37000,39000,2000,1.99,5.41,70,0.59
"3690",3690,"MouseCraft",37000,39000,2000,9.99,5.41,80,1.99
"3691",3691,"Screeps",31000,38000,7000,14.99,22.58,40,8.99
"3692",3692,"Strike Vector EX",22000,38000,16000,11.99,72.73,58,5.03
"3693",3693,"ReThink",25000,38000,13000,9.99,52,75,2.49
"3694",3694,"Luxuria Superbia",29000,38000,9000,6.99,31.03,75,1.74
"3695",3695,"NOBUNAGA'S AMBITION: Sphere of Influence",28000,38000,10000,59.99,35.71,60,23.99
"3696",3696,"Cradle",31000,38000,7000,12.99,22.58,60,5.19
"3697",3697,"Rag Doll Kung Fu",36000,38000,2000,9.99,5.56,0,9.99
"3698",3698,"The Thrill of the Fight - VR Boxing",31000,38000,7000,9.99,22.58,20,7.99
"3699",3699,"Citadels",31000,38000,7000,14.99,22.58,75,3.74
"3700",3700,"Canabalt",33000,38000,5000,2.99,15.15,66,1.01
"3701",3701,"LostWinds",27000,38000,11000,9.99,40.74,80,1.99
"3702",3702,"Fable of the Sword",21000,38000,17000,1.99,80.95,60,0.79
"3703",3703,"Mushihimesama",36000,38000,2000,19.99,5.56,60,7.99
"3704",3704,"Seraph",30000,38000,8000,12.99,26.67,70,3.89
"3705",3705,"Football, Tactics & Glory",27000,38000,11000,19.99,40.74,15,16.99
"3706",3706,"TEMBO THE BADASS ELEPHANT",33000,38000,5000,14.99,15.15,75,3.74
"3707",3707,"Reigns: Game of Thrones",0,38000,38000,3.99,0,25,2.99
"3708",3708,"200% Mixed Juice!",34000,38000,4000,6.99,11.76,60,2.79
"3709",3709,"Livelock",32000,38000,6000,9.99,18.75,75,2.49
"3710",3710,"Mashinky",33000,38000,5000,24.99,15.15,0,24.99
"3711",3711,"LaserCat",21000,38000,17000,0.99,80.95,51,0.49
"3712",3712,"Dark Void Zero",36000,38000,2000,4.99,5.56,80,0.99
"3713",3713,"Mad Combat Marines",26000,38000,12000,0.99,46.15,51,0.49
"3714",3714,"Cosmic Leap",15000,38000,23000,0.99,153.33,51,0.49
"3715",3715,"Ares Omega",36000,38000,2000,0.99,5.56,0,0.99
"3716",3716,"Panzer Warfare",35000,38000,3000,1.99,8.57,62,0.75
"3717",3717,"The Bard's Tale IV: Barrows Deep",0,38000,38000,34.99,0,20,27.99
"3718",3718,"The Charnel House Trilogy",35000,38000,3000,5.99,8.57,80,1.19
"3719",3719,"Lethis - Path of Progress",30000,38000,8000,19.99,26.67,75,4.99
"3720",3720,"Mirt. Tales of the Cold Land. Chapter one",35000,38000,3000,0.99,8.57,51,0.49
"3721",3721,"Bejeweled Deluxe",34000,38000,4000,4.99,11.76,75,1.24
"3722",3722,"Oik 2",33000,38000,5000,0.99,15.15,37,0.62
"3723",3723,"YUMENIKKI -DREAM DIARY-",24000,38000,14000,19.99,58.33,50,9.99
"3724",3724,"Chip's Challenge 1",35000,38000,3000,1.99,8.57,75,0.49
"3725",3725,"Call Of The Mighty Warriors",29000,38000,9000,0.99,31.03,75,0.49
"3726",3726,"President for a Day - Floodings",24000,38000,14000,2.99,58.33,0,2.99
"3727",3727,"Mashed",32000,38000,6000,4.99,18.75,90,0.49
"3728",3728,"Kick Ass Commandos",20000,38000,18000,9.99,90,50,4.99
"3729",3729,"Super Blood Hockey",24000,38000,14000,7.99,58.33,60,3.19
"3730",3730,"Wayward",28000,37000,9000,7.99,32.14,20,6.39
"3731",3731,"Dead Man's Draw",28000,37000,9000,6.99,32.14,50,3.49
"3732",3732,"Neon Arena",32000,37000,5000,4.99,15.63,90,0.49
"3733",3733,"Tanks vs Aliens",32000,37000,5000,4.99,15.63,80,0.99
"3734",3734,"Monument",32000,37000,5000,3.99,15.63,83,0.67
"3735",3735,"Showing Tonight: Mindhunters Incident",29000,37000,8000,4.99,27.59,50,3.49
"3736",3736,"Rock God Tycoon",13000,37000,24000,10.99,184.62,50,5.49
"3737",3737,"Sudden Strike Gold",31000,37000,6000,5.99,19.35,75,1.49
"3738",3738,"JAILBREAK",6000,37000,31000,4.99,516.67,90,0.5
"3739",3739,"Zpeciation: Tough Days (TD)",35000,37000,2000,0.99,5.71,51,0.49
"3740",3740,"Chronicles of Vinland",15000,37000,22000,5.99,146.67,50,2.99
"3741",3741,"Croixleur Sigma",30000,37000,7000,7.99,23.33,50,3.99
"3742",3742,"Lost in Paradise",31000,37000,6000,2.99,19.35,67,0.98
"3743",3743,"Planet Stronghold",35000,37000,2000,18.99,5.71,75,4.74
"3744",3744,"Torture Chamber",11000,37000,26000,0.99,236.36,40,0.59
"3745",3745,"FEIST",32000,37000,5000,9.99,15.63,80,1.99
"3746",3746,"For The Glory: A Europa Universalis Game",35000,37000,2000,9.99,5.71,75,2.49
"3747",3747,"Helen's Mysterious Castle",26000,37000,11000,1.99,42.31,40,1.19
"3748",3748,"Aeve:Zero Gravity",1000,37000,36000,1.99,3600,75,0.49
"3749",3749,"Acceleration of SUGURI X-Edition HD",35000,37000,2000,5.99,5.71,50,2.99
"3750",3750,"Pixel Boy and the Ever Expanding Dungeon",35000,37000,2000,0.99,5.71,0,0.99
"3751",3751,"Revenge of Roger Rouge",35000,37000,2000,0.99,5.71,25,0.74
"3752",3752,"Power of Love",35000,37000,2000,0.99,5.71,90,0.49
"3753",3753,"Welcome to the Game II",20000,37000,17000,9.99,85,33,6.69
"3754",3754,"Grapple",24000,37000,13000,6.99,54.17,80,1.39
"3755",3755,"Crash Wheels",12000,37000,25000,4.99,208.33,90,0.49
"3756",3756,"Typer Shark! Deluxe",33000,37000,4000,4.99,12.12,75,1.24
"3757",3757,"Bad Rats Show",33000,37000,4000,1.99,12.12,75,0.49
"3758",3758,"Pajama Sam: Games to Play on Any Day",34000,37000,3000,4.99,8.82,80,0.99
"3759",3759,"Magnetic: Cage Closed",32000,37000,5000,14.99,15.63,90,1.49
"3760",3760,"Low Magic Age",31000,37000,6000,9.99,19.35,50,3.59
"3761",3761,"The Fruit of Grisaia",33000,37000,4000,39.99,12.12,55,17.99
"3762",3762,"Words for Evil",34000,37000,3000,2.99,8.82,75,0.74
"3763",3763,"Homesick",29000,37000,8000,14.99,27.59,66,5.09
"3764",3764,"PUGNite",0,37000,37000,0.99,0,51,0.49
"3765",3765,"Apollo 11 VR",34000,37000,3000,9.69,8.82,50,4.84
"3766",3766,"Golden Dungeons",26000,37000,11000,0.99,42.31,51,0.49
"3767",3767,"HellCat",2000,37000,35000,1.99,1750,75,0.49
"3768",3768,"Jagged Alliance 1: Gold Edition",17000,37000,20000,9.99,117.65,80,1.99
"3769",3769,"SquareCells",34000,37000,3000,2.99,8.82,70,0.89
"3770",3770,"Dots eXtreme",30000,37000,7000,1.99,23.33,60,0.79
"3771",3771,"Men of Valor",23000,37000,14000,9.99,60.87,75,2.49
"3772",3772,"Infinity Wings - Scout & Grunt",26000,37000,11000,2.99,42.31,83,0.5
"3773",3773,"Unseen Diplomacy",18000,36000,18000,2.99,100,0,2.99
"3774",3774,"64.0",28000,36000,8000,2.99,28.57,55,1.34
"3775",3775,"HIVE: Altenum Wars",1000,36000,35000,9.99,3500,70,2.99
"3776",3776,"VolChaos",16000,36000,20000,2.99,125,50,1.49
"3777",3777,"Use Your Words",25000,36000,11000,14.99,44,60,5.99
"3778",3778,"MX vs. ATV Unleashed",31000,36000,5000,9.99,16.13,75,2.49
"3779",3779,"Stalingrad",33000,36000,3000,4.99,9.09,80,0.99
"3780",3780,"Realpolitiks",26000,36000,10000,24.99,38.46,75,6.24
"3781",3781,"Particulars",33000,36000,3000,5.99,9.09,0,5.99
"3782",3782,"Alice's Patchwork",33000,36000,3000,4.99,9.09,90,0.49
"3783",3783,"Gnomes Garden 2",30000,36000,6000,4.99,20,90,0.49
"3784",3784,"Them's Fightin' Herds",34000,36000,2000,14.99,5.88,25,11.24
"3785",3785,"Dustoff Heli Rescue",33000,36000,3000,3.99,9.09,87,0.51
"3786",3786,"Dreamscapes: Nightmare's Heir - Premium Edition",34000,36000,2000,6.99,5.88,80,1.39
"3787",3787,"Space Station Alpha",31000,36000,5000,5.99,16.13,0,5.99
"3788",3788,"Air Conflicts: Vietnam",31000,36000,5000,14.99,16.13,85,2.24
"3789",3789,"Line Of Defense Tactics - Tactical Advantage",32000,36000,4000,9.99,12.5,50,4.99
"3790",3790,"GEARGUNS Tank offensive",29000,36000,7000,7.99,24.14,81,1.51
"3791",3791,"Dirt Bike Insanity",0,36000,36000,5.99,0,50,2.99
"3792",3792,"SMASHING THE BATTLE",31000,36000,5000,11.99,16.13,70,3.59
"3793",3793,"Project Hospital",0,36000,36000,24.99,0,10,22.49
"3794",3794,"Clandestine",28000,36000,8000,19.99,28.57,80,3.99
"3795",3795,"EDEN STAR",26000,36000,10000,19.99,38.46,0,19.99
"3796",3796,"Lost Civilization",34000,36000,2000,4.99,5.88,75,1.24
"3797",3797,"Nantucket",25000,36000,11000,17.99,44,40,10.79
"3798",3798,"Battle Academy",33000,36000,3000,14.99,9.09,90,1.49
"3799",3799,"Last Knight: Rogue Rider Edition",27000,36000,9000,7.99,33.33,80,1.59
"3800",3800,"Haywire on Fuel Station Zeta",34000,36000,2000,3.99,5.88,0,3.99
"3801",3801,"Fester Mudd: Curse of the Gold - Episode 1",33000,36000,3000,9.99,9.09,0,9.99
"3802",3802,"Mega Man Legacy Collection 2 / ロックマン クラシックス コレクション 2",32000,36000,4000,19.99,12.5,40,11.99
"3803",3803,"Shoppe Keep 2",27000,36000,9000,14.99,33.33,20,11.69
"3804",3804,"Driver Parallel Lines",32000,36000,4000,9.99,12.5,75,2.49
"3805",3805,"Bear Haven Nights",34000,36000,2000,4.99,5.88,66,1.69
"3806",3806,"Drop The Bomb",19000,36000,17000,1.99,89.47,70,0.59
"3807",3807,"Hangover",5000,36000,31000,1.99,620,75,0.49
"3808",3808,"Lost Crew",30000,36000,6000,1.99,20,50,0.99
"3809",3809,"Leaving Lyndow",19000,36000,17000,3.99,89.47,70,1.19
"3810",3810,"Eventide 2: The Sorcerers Mirror",26000,36000,10000,9.99,38.46,60,3.99
"3811",3811,"Asphyxia",33000,36000,3000,5.99,9.09,75,1.49
"3812",3812,"HardBall",33000,36000,3000,0.99,9.09,51,0.49
"3813",3813,"Nearwood - Collector's Edition",34000,36000,2000,9.99,5.88,50,4.99
"3814",3814,"Dale Hardshovel HD",31000,36000,5000,0.99,16.13,51,0.49
"3815",3815,"Squirreltopia",31000,36000,5000,0.99,16.13,33,0.66
"3816",3816,"Ash of Gods: Redemption",24000,36000,12000,24.99,50,45,13.74
"3817",3817,"Malavision: The Origin",32000,36000,4000,4.99,12.5,70,1.49
"3818",3818,"Alien Shooter TD",25000,36000,11000,9.99,44,65,3.49
"3819",3819,"Secret Agent",26000,36000,10000,4.99,38.46,50,2.49
"3820",3820,"Explodemon",31000,36000,5000,8.99,16.13,80,1.79
"3821",3821,"Silverfall: Earth Awakening",32000,36000,4000,9.99,12.5,75,2.49
"3822",3822,"Heroes & Legends: Conquerors of Kolhar",29000,36000,7000,9.99,24.14,75,2.49
"3823",3823,"Pro Gamer Manager",32000,36000,4000,9.99,12.5,0,9.99
"3824",3824,"Aerofly FS 2 Flight Simulator",29000,36000,7000,59.99,24.14,33,40.19
"3825",3825,"ABO MANDO",27000,35000,8000,0.99,29.63,0,1.99
"3826",3826,"A Normal Lost Phone",27000,35000,8000,2.99,29.63,50,1.49
"3827",3827,"Crookz - The Big Heist",33000,35000,2000,9.99,6.06,80,1.99
"3828",3828,"Cuban Missile Crisis",32000,35000,3000,4.99,9.38,80,0.99
"3829",3829,"Moe Jigsaw",19000,35000,16000,3.99,84.21,50,1.99
"3830",3830,"Adam Wolfe",26000,35000,9000,5.99,34.62,84,0.95
"3831",3831,"Sandstorm",19000,35000,16000,5.99,84.21,70,0.54
"3832",3832,"Templar Battleforce",28000,35000,7000,9.99,25,50,4.99
"3833",3833,"Queen's Quest: Tower of Darkness",31000,35000,4000,9.99,12.9,70,2.99
"3834",3834,"Mayjasmine Episode01 - What is God?",33000,35000,2000,9.99,6.06,75,2.49
"3835",3835,"Flat Path",31000,35000,4000,0.99,12.9,51,0.49
"3836",3836,"CHKN",33000,35000,2000,14.99,6.06,35,9.74
"3837",3837,"Supreme Ruler: Cold War",33000,35000,2000,9.99,6.06,80,1.99
"3838",3838,"Stranded In Time",26000,35000,9000,1.99,34.62,50,0.99
"3839",3839,"Tompi Jones",29000,35000,6000,3.99,20.69,75,0.99
"3840",3840,"Battle Fleet 2",28000,35000,7000,14.99,25,65,5.24
"3841",3841,"8-Bit Adventures: The Forgotten Journey Remastered Edition",17000,35000,18000,9.99,105.88,60,3.99
"3842",3842,"Climbey",32000,35000,3000,9.99,9.38,25,7.49
"3843",3843,"Captain Forever Remix",30000,35000,5000,14.99,16.67,90,1.49
"3844",3844,"Stayin' Alive",26000,35000,9000,4.99,34.62,50,2.49
"3845",3845,"GAROU: MARK OF THE WOLVES",4000,35000,31000,9.99,775,50,4.99
"3846",3846,"Mistwood Heroes",30000,35000,5000,0.99,16.67,51,0.49
"3847",3847,"Guacamelee! 2",0,35000,35000,19.99,0,25,14.99
"3848",3848,"Adventures of Bertram Fiddle: Episode 1: A Dreadly Business",23000,35000,12000,4.99,52.17,50,2.49
"3849",3849,"SQUAKE",32000,35000,3000,3.99,9.38,0,3.99
"3850",3850,"Distant Star: Revenant Fleet",22000,35000,13000,9.99,59.09,75,2.49
"3851",3851,"123 Slaughter Me Street",30000,35000,5000,2.99,16.67,15,2.54
"3852",3852,"Last Inua",33000,35000,2000,7.99,6.06,75,1.99
"3853",3853,"Truck Mechanic Simulator 2015",32000,35000,3000,9.99,9.38,70,2.99
"3854",3854,"Death Rally (Classic)",13000,35000,22000,4.99,169.23,50,2.49
"3855",3855,"Tetris Ultimate",8000,35000,27000,14.99,337.5,66,5.09
"3856",3856,"UNDER NIGHT IN-BIRTH Exe:Late",28000,35000,7000,29.99,25,80,5.99
"3857",3857,"STAR-BOX: RPG Adventures in Space",27000,35000,8000,4.99,29.63,75,1.24
"3858",3858,"World of Subways 2 – Berlin Line 7",32000,35000,3000,9.99,9.38,35,6.69
"3859",3859,"Blonde Driver",2000,35000,33000,0.99,1650,51,0.49
"3860",3860,"Death Goat",33000,35000,2000,2.99,6.06,50,1.49
"3861",3861,"VoiceAttack",16000,35000,19000,11.99,118.75,50,5.99
"3862",3862,"Deep Under the Sky",32000,35000,3000,9.99,9.38,75,2.49
"3863",3863,"RKN - Roskomnadzor Banned Internet",6000,34000,28000,0.99,466.67,51,0.49
"3864",3864,"Cyto",32000,34000,2000,3.99,6.25,0,3.99
"3865",3865,"Over The Void",19000,34000,15000,4.99,78.95,90,0.49
"3866",3866,"Fallen ~Makina and the City of Ruins~",17000,34000,17000,14.99,100,35,9.74
"3867",3867,"Vampire of the Sands",32000,34000,2000,4.99,6.25,90,0.49
"3868",3868,"Raceland",12000,34000,22000,1.99,183.33,75,0.49
"3869",3869,"Hybrid Animals",29000,34000,5000,6.99,17.24,0,6.99
"3870",3870,"Fibbage XL",26000,34000,8000,9.99,30.77,60,3.99
"3871",3871,"YOU DON'T KNOW JACK Vol. 1 XL",8000,34000,26000,2.99,325,50,1.49
"3872",3872,"Ahnayro: The Dream World",26000,34000,8000,4.99,30.77,75,1.24
"3873",3873,"Krai Mira: Extended Cut",23000,34000,11000,5.99,47.83,80,1.19
"3874",3874,"Sweet Volley High",25000,34000,9000,9.99,36,50,4.99
"3875",3875,"Flat Kingdom Paper's Cut Edition",27000,34000,7000,7.99,25.93,60,3.19
"3876",3876,"Jagged Alliance Flashback",31000,34000,3000,19.99,9.68,80,3.99
"3877",3877,"BUTCHER",31000,34000,3000,9.99,9.68,60,3.99
"3878",3878,"Super Chibi Knight",20000,34000,14000,4.99,70,50,2.49
"3879",3879,"DIG IT! - A Digger Simulator",30000,34000,4000,17.99,13.33,70,5.39
"3880",3880,"Moebius: Empire Rising",29000,34000,5000,14.99,17.24,75,3.74
"3881",3881,"Abandon Ship",24000,34000,10000,19.99,41.67,25,14.99
"3882",3882,"東方憑依華　～ Antinomy of Common Flowers.",24000,34000,10000,24.99,41.67,0,24.99
"3883",3883,"Tower of Time",18000,34000,16000,24.99,88.89,40,14.99
"3884",3884,"Copoka",31000,34000,3000,4.99,9.68,33,3.34
"3885",3885,"3DMark 11",32000,34000,2000,19.99,6.25,90,1.99
"3886",3886,"Dungeon Painter Studio",30000,34000,4000,14.99,13.33,0,14.99
"3887",3887,"Monolith",9000,34000,25000,7.99,277.78,50,3.99
"3888",3888,"The Collider",30000,34000,4000,2.99,13.33,60,1.19
"3889",3889,"Super Hipster Lumberjack",29000,34000,5000,0.5,17.24,0,0.5
"3890",3890,"The Thirst of Hearts",26000,34000,8000,0.99,30.77,51,0.49
"3891",3891,"Bunnyrama",31000,34000,3000,2.99,9.68,60,1.19
"3892",3892,"The Messenger",0,34000,34000,19.99,0,30,13.99
"3893",3893,"Starship Theory",19000,34000,15000,11.99,78.95,0,11.99
"3894",3894,"Gump Runner",29000,34000,5000,0.99,17.24,51,0.49
"3895",3895,"Alpha Zylon",27000,34000,7000,4.99,25.93,90,0.49
"3896",3896,"Munich Bus Simulator",27000,34000,7000,14.99,25.93,60,7.49
"3897",3897,"Obludia",17000,34000,17000,4.99,100,80,0.99
"3898",3898,"Wonder Boy: The Dragon's Trap",29000,34000,5000,19.99,17.24,50,9.99
"3899",3899,"Ace of Protectors",11000,34000,23000,1.99,209.09,40,1.19
"3900",3900,"CrossCells",23000,34000,11000,2.99,47.83,70,0.89
"3901",3901,"Angelica Weaver: Catch Me When You Can",22000,34000,12000,13.99,54.55,60,5.59
"3902",3902,"Hexagon Defense",31000,34000,3000,3.99,9.68,87,0.51
"3903",3903,"Fantasy Grounds",29000,34000,5000,39.99,17.24,25,29.99
"3904",3904,"Chronicles of a Dark Lord: Rhapsody Clash",29000,34000,5000,0.99,17.24,30,0.69
"3905",3905,"Recovery Search & Rescue Simulation",29000,34000,5000,4.99,17.24,90,0.49
"3906",3906,"Battle Bruise",17000,34000,17000,0.99,100,51,0.49
"3907",3907,"Spring of Decadence / 堕落之春",0,34000,34000,1.99,0,30,1.39
"3908",3908,"Atari Vault",24000,34000,10000,9.99,41.67,66,3.39
"3909",3909,"Crashday Redline Edition",28000,34000,6000,11.99,21.43,70,3.59
"3910",3910,"Rime Berta",26000,34000,8000,14.99,30.77,75,3.74
"3911",3911,"Dungeon Hero",30000,34000,4000,6.99,13.33,80,1.39
"3912",3912,"Mighty Gunvolt",32000,34000,2000,4.99,6.25,75,1.24
"3913",3913,"Fantasia of the Wind - 风之幻想曲",10000,34000,24000,3.99,240,40,2.39
"3914",3914,"Disney Winnie the Pooh",27000,34000,7000,5.99,25.93,70,1.79
"3915",3915,"Ground Control II: Operation Exodus",28000,34000,6000,4.99,21.43,66,1.69
"3916",3916,"The Dwarf Run",28000,34000,6000,8.99,21.43,70,2.69
"3917",3917,"Act of War: High Treason",32000,34000,2000,2.99,6.25,60,1.19
"3918",3918,"WIN THE GAME!",15000,34000,19000,0.99,126.67,51,0.49
"3919",3919,"OddPlanet",28000,34000,6000,6.99,21.43,85,1.04
"3920",3920,"Hentai Girl Linda",0,34000,34000,0.99,0,40,0.59
"3921",3921,"Cyberpunk 3776",20000,34000,14000,4.99,70,65,2.24
"3922",3922,"Maggie's Apartment",4000,34000,30000,9.99,750,0,9.99
"3923",3923,"Tears of a Dragon",24000,34000,10000,4.99,41.67,50,2.49
"3924",3924,"Stock Car Extreme",28000,34000,6000,14.99,21.43,75,3.74
"3925",3925,"ACE Academy",26000,33000,7000,19.99,26.92,75,4.99
"3926",3926,"Comanche 4",13000,33000,20000,9.99,153.85,75,2.49
"3927",3927,"Remothered: Tormented Fathers",22000,33000,11000,19.99,50,50,9.99
"3928",3928,"Nightside",29000,33000,4000,4.99,13.79,90,0.99
"3929",3929,"Beholder 2",0,33000,33000,14.99,0,10,13.49
"3930",3930,"Hentai",15000,33000,18000,0.99,120,30,0.69
"3931",3931,"Everybody's Gone to the Rapture",31000,33000,2000,19.99,6.45,0,19.99
"3932",3932,"The Sunset",31000,33000,2000,1.99,6.45,60,0.79
"3933",3933,"Crash Time 3",30000,33000,3000,5.99,10,80,1.19
"3934",3934,"MotoGP15",29000,33000,4000,19.99,13.79,75,4.99
"3935",3935,"Bullets And More VR - BAM VR",14000,33000,19000,9.99,135.71,40,8.99
"3936",3936,"Oscura: Lost Light",27000,33000,6000,6.99,22.22,80,1.39
"3937",3937,"WRC 5 FIA World Rally Championship",30000,33000,3000,39.99,10,80,7.99
"3938",3938,"The Dreamatorium of Dr. Magnus 2",31000,33000,2000,7.99,6.45,75,1.99
"3939",3939,"HTR+ Slot Car Simulation",16000,33000,17000,6.99,106.25,75,1.74
"3940",3940,"TWINKLE STAR SPRITES",30000,33000,3000,7.99,10,50,3.99
"3941",3941,"Grey Cubes",30000,33000,3000,0.99,10,51,0.49
"3942",3942,"Unhack",31000,33000,2000,3.99,6.45,50,1.99
"3943",3943,"Touhou Luna Nights",0,33000,33000,11.99,0,20,9.59
"3944",3944,"Ship Simulator: Maritime Search and Rescue",31000,33000,2000,17.99,6.45,60,7.19
"3945",3945,"Drift Horizon Online",22000,33000,11000,4.99,50,50,2.49
"3946",3946,"Super Cuber",31000,33000,2000,2.99,6.45,67,0.98
"3947",3947,"Pizza Frenzy Deluxe",30000,33000,3000,4.99,10,75,1.24
"3948",3948,"Dungelot: Shattered Lands",29000,33000,4000,9.99,13.79,75,2.49
"3949",3949,"STAND OUT : VR Battle Royale",24000,33000,9000,24.99,37.5,60,9.99
"3950",3950,"Heroine Anthem Zero",17000,33000,16000,9.99,94.12,50,4.99
"3951",3951,"Interstellaria",27000,33000,6000,9.99,22.22,80,1.99
"3952",3952,"Leave Me Alone: A Trip To Hell",25000,33000,8000,1.99,32,0,1.99
"3953",3953,"Survive the Nights",30000,33000,3000,24.99,10,0,24.99
"3954",3954,"VALKYRIE DRIVE -BHIKKHUNI-",31000,33000,2000,29.99,6.45,25,22.49
"3955",3955,"Crime Secrets: Crimson Lily",26000,33000,7000,9.99,26.92,70,2.99
"3956",3956,"12 Labours of Hercules IV: Mother Nature (Platinum Edition)",30000,33000,3000,2.99,10,83,0.5
"3957",3957,"Battlestar Galactica Deadlock",28000,33000,5000,39.99,17.86,60,15.99
"3958",3958,"妄想症：Deliver Me",0,33000,33000,1.99,0,50,0.99
"3959",3959,"Arcana Heart 3 LOVE MAX!!!!!",28000,33000,5000,29.99,17.86,80,5.99
"3960",3960,"Flashback",27000,33000,6000,9.99,22.22,66,3.39
"3961",3961,"Rage Pig",25000,33000,8000,1.99,32,0,1.99
"3962",3962,"Three Days",23000,33000,10000,4.99,43.48,80,0.99
"3963",3963,"Faces of War",24000,33000,9000,4.99,37.5,80,0.99
"3964",3964,"Fear The Wolves",0,33000,33000,19.99,0,50,9.99
"3965",3965,"Woody Two-Legs: Attack of the Zombie Pirates",31000,33000,2000,4.99,6.45,0,4.99
"3966",3966,"There Came an Echo",30000,33000,3000,14.99,10,66,5.09
"3967",3967,"Cold War",31000,33000,2000,4.99,6.45,75,1.24
"3968",3968,"Warrior Kings: Battles",29000,33000,4000,9.99,13.79,90,0.99
"3969",3969,"牧剑：化神书(Tale Of Swords: Mystery Scroll)",6000,32000,26000,5.99,433.33,65,2.09
"3970",3970,"interLOGIC",19000,32000,13000,1.99,68.42,50,0.99
"3971",3971,"IACTURA",27000,32000,5000,0.99,18.52,30,0.69
"3972",3972,"AVSEQ",28000,32000,4000,1.99,14.29,0,1.99
"3973",3973,"Lost in the Forest",22000,32000,10000,0.99,45.45,51,0.49
"3974",3974,"STAR WARS Episode I Racer",0,32000,32000,9.99,0,25,7.49
"3975",3975,"Bombshell",12000,32000,20000,34.99,166.67,0,34.99
"3976",3976,"WIN THE GAME: DO IT!",15000,32000,17000,0.99,113.33,51,0.49
"3977",3977,"Evil Tag",12000,32000,20000,0.99,166.67,51,0.49
"3978",3978,"Soul Smith of the Kingdom",6000,32000,26000,6.99,433.33,25,5.24
"3979",3979,"UBERMOSH:BLACK",27000,32000,5000,0.99,18.52,51,0.49
"3980",3980,"THE KING OF FIGHTERS '97 GLOBAL MATCH",9000,32000,23000,9.99,255.56,50,4.99
"3981",3981,"Lepofrenia",12000,32000,20000,4.99,166.67,90,0.49
"3982",3982,"Draw a Stickman: EPIC 2",27000,32000,5000,4.99,18.52,50,2.49
"3983",3983,"Vintage Year",23000,32000,9000,2.99,39.13,75,0.74
"3984",3984,"Zolg",28000,32000,4000,0.99,14.29,51,0.49
"3985",3985,"Memento Mori",27000,32000,5000,12.99,18.52,80,2.59
"3986",3986,"Project AURA",22000,32000,10000,19.99,45.45,50,9.99
"3987",3987,"Killer Elite – Time to Die",30000,32000,2000,0.99,6.67,0,0.99
"3988",3988,"UBERMOSH Vol.3",21000,32000,11000,0.99,52.38,51,0.49
"3989",3989,"Colortone",24000,32000,8000,4.99,33.33,45,1.64
"3990",3990,"Awe",24000,32000,8000,0.99,33.33,51,0.49
"3991",3991,"Urja",18000,32000,14000,9.99,77.78,0,9.99
"3992",3992,"The Maker's Eden",29000,32000,3000,8.99,10.34,0,8.99
"3993",3993,"Fable Rush",18000,32000,14000,5.99,77.78,25,4.49
"3994",3994,"Endless Fables: The Minotaur's Curse",24000,32000,8000,9.99,33.33,60,3.99
"3995",3995,"Aporia: Beyond The Valley",14000,32000,18000,16.99,128.57,75,4.24
"3996",3996,"Wanderlust Adventures",23000,32000,9000,9.99,39.13,85,1.49
"3997",3997,"After The End: The Harvest",30000,32000,2000,4.99,6.67,60,1.99
"3998",3998,"Stranger of Sword City / 剣の街の異邦人 ～黒の宮殿～",24000,32000,8000,19.99,33.33,60,7.99
"3999",3999,"Diaries of a Spaceport Janitor",24000,32000,8000,9.99,33.33,50,4.99
"4000",4000,"Dungeon Nightmares II : The Memory",29000,32000,3000,8.99,10.34,75,2.24
"4001",4001,"Superdimension Neptune VS Sega Hard Girls | 超次元大戦ネプテューヌVSセガハードガールズ夢の合体スペシャル | 超次元大戰戰機少女VS SEGA主機娘夢幻合體特別版",25000,32000,7000,29.99,28,70,8.99
"4002",4002,"Quern - Undying Thoughts",27000,32000,5000,24.99,18.52,50,12.49
"4003",4003,"Flame Over",23000,32000,9000,11.99,39.13,80,2.39
"4004",4004,"The Legend of Dark Witch",27000,32000,5000,4.99,18.52,50,2.49
"4005",4005,"World's Dawn",26000,32000,6000,9.99,23.08,75,2.49
"4006",4006,"Captain Morgane and the Golden Turtle",30000,32000,2000,4.99,6.67,0,4.99
"4007",4007,"Wooden Floor 2 - Resurrection",22000,32000,10000,1.99,45.45,50,0.99
"4008",4008,"Miner Mayhem",20000,32000,12000,0.99,60,49,0.5
"4009",4009,"Boogeyman",26000,32000,6000,4.99,23.08,70,1.49
"4010",4010,"MiDZone",25000,32000,7000,2.99,28,0,2.99
"4011",4011,"Milford Heaven - Luken's Chronicles",28000,32000,4000,0.99,14.29,0,0.99
"4012",4012,"Art Of Gravity",28000,32000,4000,0.99,14.29,30,0.69
"4013",4013,"UBERMOSH Vol.5",30000,32000,2000,0.99,6.67,51,0.49
"4014",4014,"Regions Of Ruin",17000,32000,15000,11.99,88.24,75,2.99
"4015",4015,"Contradiction - Spot The Liar!",29000,32000,3000,9.99,10.34,0,9.99
"4016",4016,"Tyto Ecology",25000,32000,7000,6.99,28,50,3.49
"4017",4017,"Beast Battle Simulator",21000,32000,11000,9.99,52.38,25,7.49
"4018",4018,"Remnants of a Beautiful Day",21000,32000,11000,7.99,52.38,90,0.79
"4019",4019,"Tyd wag vir Niemand (Time waits for Nobody)",9000,32000,23000,9.99,255.56,55,4.49
"4020",4020,"Breathing Fear",24000,32000,8000,2.99,33.33,83,0.5
"4021",4021,"Heroes Rise: The Prodigy",29000,32000,3000,3.99,10.34,25,2.99
"4022",4022,"Nelly Cootalot: The Fowl Fleet",10000,32000,22000,19.99,220,50,9.99
"4023",4023,"You Deserve",28000,32000,4000,0.99,14.29,51,0.49
"4024",4024,"Slave Zero",30000,32000,2000,6.99,6.67,75,1.74
"4025",4025,"Cursed West",30000,32000,2000,1.99,6.67,75,0.49
"4026",4026,"NOBUNAGA'S AMBITION: Souzou (Traditional Chinese version)",27000,31000,4000,24.99,14.81,60,17.19
"4027",4027,"Project Nimbus",28000,31000,3000,19.99,10.71,33,13.39
"4028",4028,"Curvatron",28000,31000,3000,0.99,10.71,51,0.49
"4029",4029,"Big Action Mega Fight!",28000,31000,3000,1.99,10.71,50,0.99
"4030",4030,"Battle Worlds: Kronos",28000,31000,3000,19.99,10.71,75,4.99
"4031",4031,"Shardlight",18000,31000,13000,14.99,72.22,75,3.74
"4032",4032,"Wacky Wheels",14000,31000,17000,4.99,121.43,50,2.49
"4033",4033,"PIPE by BMX Streets",15000,31000,16000,9.99,106.67,0,9.99
"4034",4034,"Major\Minor - Complete Edition",18000,31000,13000,19.99,72.22,90,1.99
"4035",4035,"Achievements printer part 1",15000,31000,16000,0.99,106.67,51,0.49
"4036",4036,"Vindictive Drive",17000,31000,14000,2.99,82.35,70,0.89
"4037",4037,"女神驾到(Happy together)",0,31000,31000,6.99,0,40,4.19
"4038",4038,"Hentai 3018",3000,31000,28000,0.99,933.33,51,0.49
"4039",4039,"Interstellar Rift",28000,31000,3000,18.99,10.71,50,7.49
"4040",4040,"Doodle God: 8-bit Mania - Collector's Item",29000,31000,2000,19.99,6.9,90,1.99
"4041",4041,"The House of Da Vinci",12000,31000,19000,19.99,158.33,50,9.99
"4042",4042,"Equilinox",0,31000,31000,9.99,0,0,9.99
"4043",4043,"Hyper Bounce Blast",25000,31000,6000,4.99,24,85,0.74
"4044",4044,"NEStalgia",24000,31000,7000,9.99,29.17,60,3.99
"4045",4045,"Scarab Tales",29000,31000,2000,4.99,6.9,75,1.24
"4046",4046,"iRacing",26000,31000,5000,9.99,19.23,60,3.99
"4047",4047,"STEINS;GATE 0",20000,31000,11000,34.99,55,33,23.44
"4048",4048,"Highschool Possession",29000,31000,2000,9.99,6.9,50,3.49
"4049",4049,"FLASHOUT 2",29000,31000,2000,4.99,6.9,80,0.99
"4050",4050,"Panzer Tactics HD",29000,31000,2000,9.99,6.9,75,2.49
"4051",4051,"Lemma",21000,31000,10000,14.99,47.62,50,7.49
"4052",4052,"GOCCO OF WAR",29000,31000,2000,19.99,6.9,50,9.99
"4053",4053,"Way of the Samurai 3",19000,31000,12000,19.99,63.16,70,5.99
"4054",4054,"Bubsy Two-Fur",15000,31000,16000,4.99,106.67,60,1.99
"4055",4055,"Psebay",25000,31000,6000,9.99,24,80,1.99
"4056",4056,"Deep Fear",26000,31000,5000,0.99,19.23,37,0.62
"4057",4057,"SimpleRockets",27000,31000,4000,7.99,14.81,75,1.99
"4058",4058,"Hidden in Plain Sight",23000,31000,8000,5.99,34.78,75,1.49
"4059",4059,"Gnomes Garden 3: The thief of castles",29000,31000,2000,4.99,6.9,90,0.49
"4060",4060,"Pro Cycling Manager 2014",27000,31000,4000,9.99,14.81,75,2.49
"4061",4061,"Spooky's Jump Scare Mansion: HD Renovation",18000,31000,13000,9.99,72.22,33,6.69
"4062",4062,"Ironcast",25000,31000,6000,14.99,24,80,2.99
"4063",4063,"RYAN BLACK",22000,31000,9000,2.99,40.91,50,1.49
"4064",4064,"Guess who ?",0,31000,31000,0.99,0,51,0.49
"4065",4065,"Talisman: The Horus Heresy",28000,31000,3000,6.99,10.71,75,1.74
"4066",4066,"Good Robot",27000,31000,4000,8.99,14.81,80,1.79
"4067",4067,"AstroPop Deluxe",29000,31000,2000,4.99,6.9,75,1.24
"4068",4068,"Sky Rogue",25000,31000,6000,19.99,24,50,9.99
"4069",4069,"Nanobots",24000,31000,7000,3.99,29.17,80,0.79
"4070",4070,"The Great Escape",22000,31000,9000,3.99,40.91,87,0.51
"4071",4071,"ECHO",23000,31000,8000,24.99,34.78,50,12.49
"4072",4072,"Legion Tale",18000,31000,13000,4.99,72.22,60,1.99
"4073",4073,"Neighboring Islands",29000,31000,2000,4.99,6.9,70,1.49
"4074",4074,"Making History: The Great War",15000,31000,16000,29.99,106.67,50,14.99
"4075",4075,"FIM Speedway Grand Prix 15",14000,31000,17000,24.99,121.43,80,4.99
"4076",4076,"Katy and Bob: Safari Cafe",0,31000,31000,4.99,0,90,0.49
"4077",4077,"Heart's Medicine - Time to Heal",22000,31000,9000,12.99,40.91,75,3.24
"4078",4078,"Chicken Invaders 5",17000,31000,14000,4.99,82.35,50,2.49
"4079",4079,"游魂2-you're the only one- Tayutama 2-you're the only one-",23000,31000,8000,34.99,34.78,55,14.69
"4080",4080,"X-note",23000,31000,8000,14.99,34.78,30,10.49
"4081",4081,"The Town of Light",19000,31000,12000,18.99,63.16,78,4.17
"4082",4082,"Trapped Dead: Lockdown",25000,31000,6000,9.99,24,90,0.99
"4083",4083,"True Lover's Knot",19000,31000,12000,6.99,63.16,75,1.74
"4084",4084,"Dash Fleet",29000,31000,2000,0.99,6.9,50,0.79
"4085",4085,"Gemini Wars",29000,31000,2000,14.99,6.9,85,2.24
"4086",4086,"Niffelheim",25000,31000,6000,19.99,24,50,9.99
"4087",4087,"Age of Fear: The Undead King",24000,31000,7000,19.99,29.17,80,3.99
"4088",4088,"Season Match 2",27000,30000,3000,3.99,11.11,88,0.49
"4089",4089,"Spooky Cats",22000,30000,8000,2.99,36.36,75,0.74
"4090",4090,"ROMBY",23000,30000,7000,0.99,30.43,51,0.49
"4091",4091,"Hunt Down The Freeman",16000,30000,14000,9.99,87.5,75,2.49
"4092",4092,"Accel World VS. Sword Art Online Deluxe Edition",19000,30000,11000,49.99,57.89,70,14.99
"4093",4093,"Bomb Defense",12000,30000,18000,4.99,150,70,2.39
"4094",4094,"Aaru's Awakening",21000,30000,9000,14.99,42.86,0,14.99
"4095",4095,"Runers",28000,30000,2000,9.99,7.14,90,0.99
"4096",4096,"Motorcycle, tricycle, ATV hill racing",1000,30000,29000,0.99,2900,60,0.79
"4097",4097,"Budget Cuts",10000,30000,20000,29.99,200,30,20.99
"4098",4098,"The Adventures of Fei Duanmu 端木斐异闻录",15000,30000,15000,3.99,100,30,2.79
"4099",4099,"Voodoo Garden",26000,30000,4000,2.99,15.38,66,1.01
"4100",4100,"EmergeNYC",24000,30000,6000,34.99,25,30,24.49
"4101",4101,"Shadows: Heretic Kingdoms",23000,30000,7000,39.99,30.43,25,29.99
"4102",4102,"Roller Coaster Rampage",24000,30000,6000,9.99,25,0,9.99
"4103",4103,"Tesla vs Lovecraft",11000,30000,19000,14.99,172.73,55,6.74
"4104",4104,"hackmud",19000,30000,11000,19.99,57.89,25,14.99
"4105",4105,"Dragon Fin Soup",23000,30000,7000,19.99,30.43,75,4.99
"4106",4106,"Kings and Heroes",17000,30000,13000,14.99,76.47,0,14.99
"4107",4107,"GIGA WRECKER",27000,30000,3000,19.99,11.11,0,19.99
"4108",4108,"Rez Infinite",24000,30000,6000,24.99,25,50,12.49
"4109",4109,"Moero Chronicle | 限界凸記 モエロクロニクル | 極限凸記　萌萌編年史",19000,30000,11000,19.99,57.89,80,3.99
"4110",4110,"Word Rescue",17000,30000,13000,4.99,76.47,50,2.49
"4111",4111,"No Lights",19000,30000,11000,1.99,57.89,75,0.49
"4112",4112,"Armikrog",28000,30000,2000,9.99,7.14,80,1.99
"4113",4113,"CountDown",28000,30000,2000,5.99,7.14,80,1.19
"4114",4114,"Amerzone: The Explorer’s Legacy",22000,30000,8000,4.99,36.36,80,0.99
"4115",4115,"The Official GamingTaylor Game, Great Job!",0,30000,30000,9.99,0,90,0.59
"4116",4116,"HoloBall",25000,30000,5000,14.99,20,50,7.49
"4117",4117,"Rayman Raving Rabbids",27000,30000,3000,9.99,11.11,66,3.39
"4118",4118,"#monstercakes",22000,30000,8000,0.99,36.36,51,0.49
"4119",4119,"Carnivores: Dinosaur Hunter Reborn",26000,30000,4000,14.99,15.38,50,7.49
"4120",4120,"A.I.M. Racing",28000,30000,2000,2.99,7.14,77,0.68
"4121",4121,"Nightork Adventures - Beyond the Moons of Shadalee",13000,30000,17000,1.99,130.77,75,0.49
"4122",4122,"CLANNAD Side Stories",24000,30000,6000,19.99,25,70,5.99
"4123",4123,"You Are Not A Banana: Better Edition",28000,30000,2000,0.99,7.14,30,0.69
"4124",4124,"Treasures of the Ancients: Egypt",9000,30000,21000,0.99,233.33,51,0.49
"4125",4125,"Hidden Object Bundle 5 in 1",27000,30000,3000,9.99,11.11,75,2.49
"4126",4126,"OrbusVR",18000,30000,12000,39.99,66.67,30,27.99
"4127",4127,"Your Bunny Wrote",10000,30000,20000,1.99,200,75,0.49
"4128",4128,"Tomb Raider - The Final Hours Digital Book",24000,30000,6000,1.99,25,75,0.49
"4129",4129,"Dungeonbowl - Knockout Edition",27000,30000,3000,12.99,11.11,90,1.29
"4130",4130,"Arcane Worlds",28000,30000,2000,9.99,7.14,0,9.99
"4131",4131,"Supreme Ruler 1936",27000,30000,3000,12.99,11.11,80,2.59
"4132",4132,"Please, Don't Touch Anything 3D",21000,30000,9000,14.99,42.86,65,5.24
"4133",4133,"NoLimits 2 Roller Coaster Simulation",27000,30000,3000,39.99,11.11,40,23.99
"4134",4134,"Acceleration of SUGURI 2",7000,30000,23000,8.99,328.57,25,6.74
"4135",4135,"Republique",28000,30000,2000,9.99,7.14,80,4.99
"4136",4136,"Cubot",27000,30000,3000,1.99,11.11,0,1.99
"4137",4137,"Pizza Express",26000,30000,4000,6.99,15.38,90,0.69
"4138",4138,"Sébastien Loeb Rally EVO",21000,30000,9000,19.99,42.86,75,4.99
"4139",4139,"Secret Files 2: Puritas Cordis",23000,30000,7000,9.99,30.43,75,2.49
"4140",4140,"Theatre Of The Absurd",27000,30000,3000,4.99,11.11,90,0.49
"4141",4141,"Nancy Drew: Shadow at the Water's Edge",26000,30000,4000,6.99,15.38,40,4.19
"4142",4142,"Clans",28000,30000,2000,2.99,7.14,83,0.5
"4143",4143,"Phoning Home",22000,30000,8000,19.99,36.36,80,3.99
"4144",4144,"Perimeter",20000,30000,10000,3.99,50,75,0.99
"4145",4145,"Jelly Killer",20000,30000,10000,3.99,50,88,0.49
"4146",4146,"The Temporal Invasion",26000,30000,4000,6.99,15.38,65,2.44
"4147",4147,"Salammbô: Battle for Carthage",28000,30000,2000,4.99,7.14,60,1.99
"4148",4148,"The Cat! Porfirio's Adventure",23000,30000,7000,3.99,30.43,87,0.51
"4149",4149,"Project First Contact",15000,30000,15000,2.99,100,84,0.49
"4150",4150,"Save Your Mother",22000,30000,8000,3.99,36.36,50,1.99
"4151",4151,"The Treasures of Montezuma 4",28000,30000,2000,6.99,7.14,90,0.69
"4152",4152,"To Ash",12000,30000,18000,1.99,150,50,0.99
"4153",4153,"Redeemer",25000,30000,5000,14.99,20,80,2.99
"4154",4154,"Captain Firebeard and the Bay of Crows",19000,29000,10000,5.99,52.63,80,1.19
"4155",4155,"Space Drifters 2D",19000,29000,10000,0.99,52.63,51,0.49
"4156",4156,"Ski Sniper",15000,29000,14000,4.99,93.33,0,4.99
"4157",4157,"Plankton",22000,29000,7000,1.99,31.82,20,1.59
"4158",4158,"Cliff Empire",20000,29000,9000,8.99,45,10,8.09
"4159",4159,"Raptor: Call of the Shadows (1994 Classic Edition)",14000,29000,15000,4.99,107.14,50,2.49
"4160",4160,"Romopolis",27000,29000,2000,3.99,7.41,75,0.99
"4161",4161,"Raptor: Call of The Shadows - 2015 Edition",26000,29000,3000,4.99,11.54,50,2.49
"4162",4162,"Race for the Galaxy",3000,29000,26000,6.99,866.67,30,4.89
"4163",4163,"Calvino Noir",27000,29000,2000,6.99,7.41,90,0.69
"4164",4164,"Sudden Strike 2 Gold",25000,29000,4000,5.99,16,75,1.49
"4165",4165,"Juicy Realm",19000,29000,10000,9.99,52.63,25,7.49
"4166",4166,"Space Girls",21000,29000,8000,0.99,38.1,51,0.49
"4167",4167,"Tomoyo After ~It's a Wonderful Life~ English Edition",27000,29000,2000,19.99,7.41,70,5.99
"4168",4168,"Nanofights",13000,29000,16000,1.99,123.08,75,0.49
"4169",4169,"Warlords Battlecry III",21000,29000,8000,9.99,38.1,40,5.99
"4170",4170,"FIVE: Guardians of David",17000,29000,12000,9.99,70.59,75,2.49
"4171",4171,"Midnight Outlaw: 6 Hours to SunUp",10000,29000,19000,9.99,190,75,2.49
"4172",4172,"Megaquarium",0,29000,29000,24.99,0,20,19.99
"4173",4173,"8-Bit Invaders!",26000,29000,3000,14.99,11.54,67,4.94
"4174",4174,"Band of Defenders",8000,29000,21000,13.99,262.5,40,8.39
"4175",4175,"Adventurezator: When Pigs Fly",25000,29000,4000,19.99,16,80,3.99
"4176",4176,"Tropical Liquor",17000,29000,12000,9.99,70.59,40,5.99
"4177",4177,"Noob Squad",26000,29000,3000,0.99,11.54,51,0.49
"4178",4178,"IS Defense",27000,29000,2000,5.99,7.41,60,2.39
"4179",4179,"Trainz: Classic Cabon City",26000,29000,3000,19.99,11.54,65,6.99
"4180",4180,"RAID: World War II",27000,29000,2000,19.99,7.41,75,4.99
"4181",4181,"Magic Technology",22000,29000,7000,2.99,31.82,75,1.74
"4182",4182,"Solitaire Beach Season",23000,29000,6000,4.99,26.09,90,0.49
"4183",4183,"MANOS",26000,29000,3000,2.99,11.54,60,1.19
"4184",4184,"Pulstar",22000,29000,7000,1.99,31.82,75,0.49
"4185",4185,"Space Hulk: Deathwing - Enhanced Edition",18000,29000,11000,39.99,61.11,66,13.59
"4186",4186,"Hentai Memory",0,29000,29000,0.99,0,51,0.49
"4187",4187,"Super Fancy Pants Adventure",15000,29000,14000,9.99,93.33,40,5.99
"4188",4188,"ORCS",24000,29000,5000,1.99,20.83,75,0.49
"4189",4189,"Cross of the Dutchman",17000,29000,12000,8.99,70.59,65,3.14
"4190",4190,"Simple VR Video Player",26000,29000,3000,7.99,11.54,0,7.99
"4191",4191,"Cloudlands : VR Minigolf",27000,29000,2000,19.99,7.41,50,9.99
"4192",4192,"Lost Horizon 2",26000,29000,3000,14.99,11.54,75,3.74
"4193",4193,"河洛群俠傳 (Ho Tu Lo Shu ： The Books of Dragon)",0,29000,29000,17.99,0,10,16.19
"4194",4194,"Druid",7000,29000,22000,1.99,314.29,75,0.49
"4195",4195,"Go Home Dinosaurs!",26000,29000,3000,9.99,11.54,75,2.49
"4196",4196,"Arctico",25000,29000,4000,9.99,16,70,2.99
"4197",4197,"Mystery Of Rivenhallows",23000,29000,6000,2.99,26.09,80,0.59
"4198",4198,"Academia : School Simulator",21000,29000,8000,19.99,38.1,25,14.99
"4199",4199,"RIOT - Civil Unrest",21000,29000,8000,12.99,38.1,33,8.7
"4200",4200,"Super Dungeon Boy",18000,29000,11000,0.99,61.11,51,0.49
"4201",4201,"Minit",15000,29000,14000,9.99,93.33,40,5.99
"4202",4202,"Nights of Azure",24000,29000,5000,29.99,20.83,30,20.99
"4203",4203,"Miner Meltdown",15000,29000,14000,6.99,93.33,70,2.09
"4204",4204,"Carrier Deck",13000,29000,16000,9.99,123.08,50,4.99
"4205",4205,"KNIGHTS",27000,29000,2000,0.99,7.41,51,0.49
"4206",4206,"Undead Hunter",25000,29000,4000,1.99,16,50,0.99
"4207",4207,"Delta Force Land Warrior",26000,29000,3000,9.99,11.54,75,2.49
"4208",4208,"The Fall of the Dungeon Guardians - Enhanced Edition",26000,29000,3000,19.99,11.54,75,4.99
"4209",4209,"Empress Of The Deep",27000,29000,2000,4.99,7.41,90,0.49
"4210",4210,"Super Star Path",22000,29000,7000,4.99,31.82,75,0.49
"4211",4211,"Masha Rescues Grandma",15000,29000,14000,3.99,93.33,87,0.51
"4212",4212,"Dynamite Alex",25000,29000,4000,0.99,16,51,0.49
"4213",4213,"Trash Story",1000,29000,28000,0.99,2800,51,0.49
"4214",4214,"Crazy Pixel Streaker",24000,29000,5000,4.99,20.83,75,1.24
"4215",4215,"BattleRush 2",0,29000,29000,4.99,0,10,4.49
"4216",4216,"Adventure Time: Finn and Jake's Epic Quest",25000,29000,4000,9.99,16,33,6.69
"4217",4217,"All That Remains",6000,29000,23000,3.99,383.33,50,1.99
"4218",4218,"Tower 57",11000,28000,17000,11.99,154.55,55,5.39
"4219",4219,"Serafina's Crown",18000,28000,10000,7.99,55.56,66,2.71
"4220",4220,"Ascension: Deckbuilding Game",15000,28000,13000,9.99,86.67,60,3.99
"4221",4221,"Engare",8000,28000,20000,6.99,250,25,5.24
"4222",4222,"Stay Close",19000,28000,9000,8.99,47.37,34,5.93
"4223",4223,"Small Town Terrors Pilgrim's Hook Collector's Edition",19000,28000,9000,14.99,47.37,75,3.74
"4224",4224,"ROOT",9000,28000,19000,9.99,211.11,90,0.99
"4225",4225,"Collider",20000,28000,8000,2.99,40,0,2.99
"4226",4226,"Siralim",23000,28000,5000,9.99,21.74,90,0.99
"4227",4227,"Pain Train 2",8000,28000,20000,6.99,250,90,0.69
"4228",4228,"Sky Force Reloaded",20000,28000,8000,9.99,40,50,4.99
"4229",4229,"Conception II: Children of the Seven Stars",23000,28000,5000,19.99,21.74,70,5.99
"4230",4230,"Pixel Space",24000,28000,4000,4.99,16.67,0,4.99
"4231",4231,"Battlepillars Gold Edition",25000,28000,3000,4.99,12,50,2.49
"4232",4232,"Ys VIII: Lacrimosa of DANA / イースVIII-Lacrimosa of DANA-",18000,28000,10000,59.99,55.56,20,47.99
"4233",4233,"The Floor is Jelly",24000,28000,4000,9.99,16.67,90,0.99
"4234",4234,"Lucidity",24000,28000,4000,5.99,16.67,66,2.03
"4235",4235,"Command: Modern Air / Naval Operations WOTY",26000,28000,2000,79.99,7.69,67,26.39
"4236",4236,"Government Simulator",8000,28000,20000,9.99,250,0,9.99
"4237",4237,"WWE 2K19",0,28000,28000,59.99,0,50,29.99
"4238",4238,"Sneak Thief",23000,28000,5000,9.99,21.74,50,4.99
"4239",4239,"EVE: Valkyrie – Warzone",24000,28000,4000,29.99,16.67,50,14.99
"4240",4240,"Super Army of Tentacles 3: The Search for Army of Tentacles 2",26000,28000,2000,10.99,7.69,40,6.59
"4241",4241,"LoveChoice 拣爱",0,28000,28000,1.99,0,40,1.19
"4242",4242,"Elliot Quest",25000,28000,3000,9.99,12,0,9.99
"4243",4243,"An Alien with a Magnet",18000,28000,10000,2.99,55.56,70,0.89
"4244",4244,"ADOM (Ancient Domains Of Mystery)",24000,28000,4000,14.99,16.67,10,13.49
"4245",4245,"Thrillville: Off the Rails",25000,28000,3000,9.99,12,66,3.39
"4246",4246,"Save the Dodos",20000,28000,8000,2.99,40,84,0.49
"4247",4247,"TO THE TOP",18000,28000,10000,19.99,55.56,50,9.99
"4248",4248,"The Cat Games",20000,28000,8000,1.99,40,50,0.99
"4249",4249,"10 Second Ninja X",25000,28000,3000,9.99,12,75,2.49
"4250",4250,"The Jackbox Party Pack 5",0,28000,28000,29.99,0,25,22.49
"4251",4251,"Bleeding Border",19000,28000,9000,4.99,47.37,50,2.49
"4252",4252,"Plancon: Space Conflict",23000,28000,5000,6.99,21.74,90,0.69
"4253",4253,"Zup! X",12000,28000,16000,0.99,133.33,30,0.69
"4254",4254,"Pretentious Game",23000,28000,5000,1.99,21.74,50,0.99
"4255",4255,"Witch Hunt",8000,28000,20000,9.99,250,15,8.49
"4256",4256,"Goggles - World of Vaporia",22000,28000,6000,7.99,27.27,0,7.99
"4257",4257,"Death Stair",23000,28000,5000,1.99,21.74,83,0.49
"4258",4258,"Princess Maker 2 Refine",22000,28000,6000,19.99,27.27,60,7.99
"4259",4259,"Professional Lumberjack 2015",22000,28000,6000,19.99,27.27,75,4.99
"4260",4260,"FoxyLand",20000,28000,8000,2.99,40,65,1.04
"4261",4261,"Moekuri: Adorable + Tactical SRPG",20000,28000,8000,11.99,40,60,4.79
"4262",4262,"Blackwater Bayou VR",13000,28000,15000,0.99,115.38,51,0.49
"4263",4263,"Pixel Gladiator",20000,28000,8000,4.99,40,80,0.99
"4264",4264,"Third Front: WWII",18000,28000,10000,7.99,55.56,75,1.99
"4265",4265,"Zombie Estate 2",13000,28000,15000,4.99,115.38,50,2.49
"4266",4266,"Disgaea 5 Complete / 魔界戦記ディスガイア5",0,28000,28000,39.99,0,25,29.99
"4267",4267,"SpyParty",12000,28000,16000,24.99,133.33,0,24.99
"4268",4268,"DeathMetal",23000,28000,5000,2.99,21.74,75,0.74
"4269",4269,"The Club",26000,28000,2000,14.99,7.69,90,1.49
"4270",4270,"Stop Online - Battle of Words",18000,28000,10000,4.99,55.56,0,4.99
"4271",4271,"Disney Pirates of the Caribbean: At Worlds End",14000,28000,14000,19.99,100,70,5.99
"4272",4272,"位面穿越者-三国传(A Bit Crosser-Three Kingdoms)",25000,28000,3000,1.99,12,70,0.59
"4273",4273,"Fist of love",0,28000,28000,0.99,0,20,0.79
"4274",4274,"Hidden Object 6-in-1 bundle",25000,28000,3000,11.99,12,75,2.99
"4275",4275,"Chasm",5000,28000,23000,19.99,460,15,16.99
"4276",4276,"room13",26000,28000,2000,7.99,7.69,80,1.59
"4277",4277,"Red Comrades Save the Galaxy: Reloaded",19000,28000,9000,3.99,47.37,60,1.59
"4278",4278,"Beautiful Japanese Scenery - Animated Jigsaws",7000,28000,21000,9.99,300,90,0.99
"4279",4279,"PONCHO",20000,28000,8000,9.99,40,75,2.49
"4280",4280,"!AnyWay!",1000,27000,26000,1.99,2600,75,0.49
"4281",4281,"Baseball Mogul Diamond",22000,27000,5000,11.99,22.73,80,2.39
"4282",4282,"Megapolis",23000,27000,4000,3.99,17.39,75,0.99
"4283",4283,"Music Racer",0,27000,27000,1.99,0,50,0.99
"4284",4284,"Daily Run",2000,27000,25000,0.99,1250,0,0.99
"4285",4285,"Realms of Chaos",16000,27000,11000,4.99,68.75,50,2.49
"4286",4286,"The Darkside Detective",13000,27000,14000,12.99,107.69,40,7.79
"4287",4287,"Albino Lullaby: Episode 1",20000,27000,7000,9.99,35,40,5.99
"4288",4288,"Wick",23000,27000,4000,5.99,17.39,50,2.99
"4289",4289,"The first thrust of God",9000,27000,18000,6.99,200,75,1.74
"4290",4290,"Easy Red",15000,27000,12000,3.99,80,40,2.39
"4291",4291,"A Game of Changes",24000,27000,3000,4.99,12.5,75,1.24
"4292",4292,"Construction Machines Simulator 2016",21000,27000,6000,9.99,28.57,75,2.49
"4293",4293,"Oh No! Bugs!",22000,27000,5000,1.99,22.73,60,0.49
"4294",4294,"Meltys Quest",22000,27000,5000,19.99,22.73,40,11.99
"4295",4295,"Space Food Truck",13000,27000,14000,9.99,107.69,75,2.49
"4296",4296,"Hypt",16000,27000,11000,4.99,68.75,0,4.99
"4297",4297,"Enola",25000,27000,2000,14.99,8,90,1.49
"4298",4298,"Paint it Back",12000,27000,15000,7.99,125,50,3.99
"4299",4299,"Shad'O",23000,27000,4000,4.99,17.39,75,1.24
"4300",4300,"One Night Stand",23000,27000,4000,2.99,17.39,50,1.49
"4301",4301,"Just Dance 2017",24000,27000,3000,49.99,12.5,66,16.99
"4302",4302,"Pretty Girls Panic!",23000,27000,4000,1.99,17.39,50,0.99
"4303",4303,"Zotrix - Solar Division",25000,27000,2000,14.99,8,50,7.49
"4304",4304,"Of Carrots And Blood",22000,27000,5000,2.99,22.73,0,2.99
"4305",4305,"Ninja Way",18000,27000,9000,1.99,50,75,0.49
"4306",4306,"Heroic Dungeon",18000,27000,9000,3.99,50,30,2.79
"4307",4307,"Mugen Souls",21000,27000,6000,19.99,28.57,75,4.99
"4308",4308,"Bad North",0,27000,27000,14.99,0,10,13.49
"4309",4309,"The Flock",23000,27000,4000,16.99,17.39,66,5.77
"4310",4310,"Serious Sam's Bogus Detour",19000,27000,8000,14.99,42.11,50,7.49
"4311",4311,"Vampires!",20000,27000,7000,1.99,35,75,0.49
"4312",4312,"1bitHeart",19000,27000,8000,2.99,42.11,30,2.09
"4313",4313,"F-22 Lightning 3",22000,27000,5000,9.99,22.73,75,2.49
"4314",4314,"HEADLINER",12000,27000,15000,2.99,125,33,2
"4315",4315,"Dub Dash",24000,27000,3000,4.99,12.5,65,1.74
"4316",4316,"Sense of The Devil",16000,27000,11000,0.99,68.75,51,0.49
"4317",4317,"Bang Bang Fruit 2",11000,27000,16000,0.99,145.45,51,0.49
"4318",4318,"Notch - The Innocent LunA: Eclipsed SinnerS",17000,27000,10000,9.99,58.82,60,3.99
"4319",4319,"StarFence: Heroic Edition",16000,27000,11000,2.99,68.75,0,2.99
"4320",4320,"Crazy Machines: Golden Gears",25000,27000,2000,9.99,8,50,4.99
"4321",4321,"Talismania Deluxe",25000,27000,2000,4.99,8,75,1.24
"4322",4322,"Loki",25000,27000,2000,9.99,8,85,1.49
"4323",4323,"DARIUSBURST Chronicle Saviours",24000,27000,3000,49.99,12.5,60,19.99
"4324",4324,"Proxy Blade Zero",24000,27000,3000,6.99,12.5,60,2.79
"4325",4325,"MXGP2 - The Official Motocross Videogame",24000,27000,3000,29.99,12.5,80,5.99
"4326",4326,"SHOCK TROOPERS",21000,27000,6000,7.99,28.57,50,3.99
"4327",4327,"Claustrophobia: The Downward Struggle",22000,27000,5000,4.99,22.73,0,4.99
"4328",4328,"Pinstripe",21000,27000,6000,14.99,28.57,50,7.49
"4329",4329,"Casino Poker",1000,27000,26000,2.99,2600,70,0.89
"4330",4330,"City of Fools",25000,27000,2000,7.99,8,75,1.99
"4331",4331,"Warlocks vs Shadows",25000,27000,2000,13.99,8,0,13.99
"4332",4332,"Urban Chaos",21000,27000,6000,6.99,28.57,86,0.97
"4333",4333,"EXAPUNKS",0,27000,27000,19.99,0,20,15.99
"4334",4334,"HOMEBOUND",6000,27000,21000,8.99,350,0,8.99
"4335",4335,"Cube - The Jumper",2000,27000,25000,1.99,1250,75,0.49
"4336",4336,"htoL#NiQ: The Firefly Diary / htoL#NiQ-ホタルノニッキ-",19000,27000,8000,9.99,42.11,60,3.99
"4337",4337,"Delta Force: Task Force Dagger",12000,27000,15000,9.99,125,75,2.49
"4338",4338,"Popap",23000,27000,4000,0.99,17.39,0,0.99
"4339",4339,"Farabel",6000,27000,21000,9.99,350,60,3.99
"4340",4340,"The Land Of Lamia",17000,27000,10000,0.99,58.82,0,0.99
"4341",4341,"Streamline",20000,27000,7000,10.99,35,0,10.99
"4342",4342,"FATE: The Traitor Soul",22000,27000,5000,7.99,22.73,0,7.99
"4343",4343,"The Wizard's Pen",25000,27000,2000,4.99,8,75,1.24
"4344",4344,"侠客风云传前传(Tale of Wuxia:The Pre-Sequel)",13000,27000,14000,16.99,107.69,0,16.99
"4345",4345,"Shutter",24000,26000,2000,1.99,8.33,75,0.49
"4346",4346,"Pepe Porcupine",17000,26000,9000,0.99,52.94,80,0.49
"4347",4347,"I Am The Hero",21000,26000,5000,9.99,23.81,60,3.99
"4348",4348,"Get CARNAGE!!!",22000,26000,4000,3.99,18.18,87,0.51
"4349",4349,"Nicolas Eymerich - The Inquisitor - Book 1 : The Plague",21000,26000,5000,4.99,23.81,80,0.99
"4350",4350,"The Clans - Saga of the Twins",24000,26000,2000,9.99,8.33,75,2.49
"4351",4351,"An Imp? A Fiend!",24000,26000,2000,0.99,8.33,51,0.49
"4352",4352,"Imperium Galactica II",14000,26000,12000,9.99,85.71,75,2.49
"4353",4353,"Constructor",16000,26000,10000,29.99,62.5,80,5.99
"4354",4354,"Cloudberry Kingdom",24000,26000,2000,9.99,8.33,75,2.49
"4355",4355,"Season Match 3 - Curse of the Witch Crow",24000,26000,2000,4.99,8.33,90,0.49
"4356",4356,"Kromaia",24000,26000,2000,19.99,8.33,75,4.99
"4357",4357,"Final Rush",22000,26000,4000,4.99,18.18,0,4.99
"4358",4358,"Hentai Temple",0,26000,26000,0.99,0,51,0.49
"4359",4359,"Anima Gate of Memories",20000,26000,6000,19.99,30,50,9.99
"4360",4360,"Evil Defenders",18000,26000,8000,9.99,44.44,0,9.99
"4361",4361,"Devils & Demons",14000,26000,12000,9.99,85.71,75,2.49
"4362",4362,"Deep Space Waifu: FANTASY",0,26000,26000,1.99,0,30,1.39
"4363",4363,"Running Gods",15000,26000,11000,4.99,73.33,65,1.74
"4364",4364,"VR Kanojo / VRカノジョ",21000,26000,5000,49.99,23.81,40,29.99
"4365",4365,"Mystery Village: Shards of the Past",12000,26000,14000,3.99,116.67,75,0.99
"4366",4366,"KeeperRL",21000,26000,5000,14.99,23.81,0,14.99
"4367",4367,"Warrior Kings",24000,26000,2000,9.99,8.33,90,0.99
"4368",4368,"Donut County",0,26000,26000,12.99,0,20,10.39
"4369",4369,"HERO DEFENSE",23000,26000,3000,29.99,13.04,40,17.99
"4370",4370,"SIMULACRA",14000,26000,12000,4.99,85.71,30,3.49
"4371",4371,"Evil Genome 光明重影",12000,26000,14000,14.99,116.67,0,14.99
"4372",4372,"Dying Light: Bad Blood",0,26000,26000,19.99,0,10,17.99
"4373",4373,"Zombies on a Plane",11000,26000,15000,4.99,136.36,80,0.99
"4374",4374,"SHOWTIME 2073",23000,26000,3000,1.99,13.04,50,0.99
"4375",4375,"Disposable Heroes",14000,26000,12000,4.99,85.71,90,0.49
"4376",4376,"Orion: A Sci-Fi Visual Novel",18000,26000,8000,12.99,44.44,90,1.29
"4377",4377,"Favorite Miner",8000,26000,18000,4.99,225,87,0.5
"4378",4378,"Block Story",24000,26000,2000,2.99,8.33,0,2.99
"4379",4379,"Into the Void",24000,26000,2000,4.99,8.33,0,4.99
"4380",4380,"Mushroom Wars 2",22000,26000,4000,14.99,18.18,35,9.74
"4381",4381,"Hegemony III: Clash of the Ancients",22000,26000,4000,29.99,18.18,80,5.99
"4382",4382,"Pixel Star",23000,26000,3000,2.99,13.04,50,1.49
"4383",4383,"President for a Day - Corruption",23000,26000,3000,2.99,13.04,0,2.99
"4384",4384,"The Music Machine",22000,26000,4000,4.99,18.18,60,1.99
"4385",4385,"Blue Toad Murder Files: The Mysteries of Little Riddle",23000,26000,3000,4.49,13.04,0,4.49
"4386",4386,"Inbetween Land",19000,26000,7000,6.99,36.84,86,0.97
"4387",4387,"DreamBreak",16000,26000,10000,6.99,62.5,70,2.09
"4388",4388,"Scribble Space",16000,26000,10000,1.99,62.5,60,0.79
"4389",4389,"Sherlock Holmes Consulting Detective: The Case of the Mummy's Curse",22000,26000,4000,2.99,18.18,75,0.74
"4390",4390,"Bottle_Shooter",11000,26000,15000,0.99,136.36,0,0.99
"4391",4391,"Putrefaction 2: Void Walker",12000,26000,14000,4.99,116.67,90,0.49
"4392",4392,"Statues",23000,26000,3000,4.99,13.04,70,1.49
"4393",4393,"Hentai: Exposed",9000,26000,17000,0.99,188.89,30,0.69
"4394",4394,"Cosmic Star Heroine",23000,26000,3000,14.99,13.04,60,5.99
"4395",4395,"Tokyo 42",15000,26000,11000,19.99,73.33,60,7.99
"4396",4396,"Rush for Berlin Gold",24000,26000,2000,4.99,8.33,50,2.49
"4397",4397,"Three Kingdoms: The Last Warlord | 三国志:汉末霸业",23000,26000,3000,16.99,13.04,40,10.19
"4398",4398,"MotoGP14",24000,26000,2000,19.99,8.33,80,3.99
"4399",4399,"Dwarf Tower",24000,26000,2000,0.99,8.33,0,0.99
"4400",4400,"Poker Pretty Girls Battle: Texas Hold'em",24000,26000,2000,9.99,8.33,85,1.49
"4401",4401,"Season of 12 Colors",21000,26000,5000,2.99,23.81,20,2.39
"4402",4402,"Tiltagon",18000,26000,8000,2.99,44.44,80,0.59
"4403",4403,"Pumped BMX +",15000,26000,11000,9.99,73.33,75,2.49
"4404",4404,"BomberZone",21000,26000,5000,1.99,23.81,50,0.99
"4405",4405,"Bombernauts",7000,26000,19000,9.99,271.43,80,1.99
"4406",4406,"The Next World",12000,26000,14000,12.99,116.67,90,1.29
"4407",4407,"FINAL FANTASY XI: Ultimate Collection Seekers Edition",20000,26000,6000,29.99,30,67,9.89
"4408",4408,"Hoo-Boy",20000,26000,6000,1.99,30,75,0.49
"4409",4409,"OZMAFIA!!",11000,26000,15000,34.99,136.36,50,17.49
"4410",4410,"Boss Monster",22000,25000,3000,4.99,13.64,0,4.99
"4411",4411,"The Room Three",0,25000,25000,5.99,0,0,5.99
"4412",4412,"Serious Sam 3 VR: BFE",20000,25000,5000,39.99,25,75,9.99
"4413",4413,"Codename: Panzers, Phase One",21000,25000,4000,14.99,19.05,75,3.74
"4414",4414,"Where's My Helmet?",19000,25000,6000,0.99,31.58,51,0.49
"4415",4415,"Sunset Rangers",22000,25000,3000,9.99,13.64,75,2.49
"4416",4416,"Megamagic: Wizards of the Neon Age",20000,25000,5000,9.99,25,70,2.99
"4417",4417,"Weird Park Trilogy",22000,25000,3000,19.99,13.64,75,4.99
"4418",4418,"Visitors",21000,25000,4000,4.99,19.05,0,4.99
"4419",4419,"Trianguluv",19000,25000,6000,1.99,31.58,70,0.59
"4420",4420,"The Guest",20000,25000,5000,9.99,25,75,2.49
"4421",4421,"Empress Of The Deep 2: Song Of The Blue Whale",23000,25000,2000,4.99,8.7,90,0.49
"4422",4422,"Furious Angels",6000,25000,19000,4.99,316.67,70,1.49
"4423",4423,"Goosebumps: The Game",22000,25000,3000,9.99,13.64,75,2.49
"4424",4424,"Giana Sisters: Dream Runners",18000,25000,7000,9.99,38.89,75,2.49
"4425",4425,"O'Fox Life",19000,25000,6000,0.99,31.58,51,0.49
"4426",4426,"ISLANDS: Non-Places",10000,25000,15000,4.99,150,80,0.99
"4427",4427,"Tokyo Dark",21000,25000,4000,17.99,19.05,40,10.79
"4428",4428,"The Agency: Chapter 1",7000,25000,18000,2.99,257.14,66,1.01
"4429",4429,"TASTEE: Lethal Tactics",20000,25000,5000,14.99,25,90,1.49
"4430",4430,"VOI",23000,25000,2000,0.99,8.7,51,0.49
"4431",4431,"Sonny",5000,25000,20000,4.99,400,50,2.49
"4432",4432,"Prison Run and Gun",23000,25000,2000,2.99,8.7,83,0.5
"4433",4433,"Love Ribbon",18000,25000,7000,9.99,38.89,45,5.49
"4434",4434,"Tasty Planet: Back for Seconds",23000,25000,2000,5.99,8.7,40,3.59
"4435",4435,"City of Brass",13000,25000,12000,19.99,92.31,50,9.99
"4436",4436,"Storm",17000,25000,8000,9.99,47.06,80,1.99
"4437",4437,"Sky Break",21000,25000,4000,9.99,19.05,75,2.49
"4438",4438,"Corpse Party",17000,25000,8000,14.99,47.06,35,9.74
"4439",4439,"123 Slaughter Me Street 2",16000,25000,9000,4.99,56.25,15,4.24
"4440",4440,"Seven: The Days Long Gone",15000,25000,10000,29.99,66.67,50,14.99
"4441",4441,"CITYCONOMY: Service for your City",22000,25000,3000,24.99,13.64,70,7.49
"4442",4442,"Home is Where One Starts...",23000,25000,2000,2.99,8.7,83,0.5
"4443",4443,"StarCrawlers",20000,25000,5000,19.99,25,50,9.99
"4444",4444,"Duck Season",22000,25000,3000,19.99,13.64,35,12.99
"4445",4445,"Inside My Radio",22000,25000,3000,14.99,13.64,85,2.24
"4446",4446,"Princess Maker Refine",18000,25000,7000,9.99,38.89,45,5.49
"4447",4447,"Four Last Things",15000,25000,10000,7.99,66.67,75,1.99
"4448",4448,"Euclidean",21000,25000,4000,4.99,19.05,85,0.74
"4449",4449,"Mahjong Magic Journey",22000,25000,3000,4.99,13.64,90,0.49
"4450",4450,"Mosaics Galore",0,25000,25000,4.99,0,90,0.49
"4451",4451,"甜点恋人 / Pastry Lovers",17000,25000,8000,4.99,47.06,90,0.49
"4452",4452,"Earn to Die 2",15000,25000,10000,4.99,66.67,40,2.99
"4453",4453,"One Last Chance",18000,25000,7000,3.99,38.89,66,1.35
"4454",4454,"GTGD S1: More Than a Gamer",23000,25000,2000,14.99,8.7,10,13.49
"4455",4455,"Paradigm Shift",23000,25000,2000,1.99,8.7,75,0.49
"4456",4456,"Mutant Storm: Reloaded",23000,25000,2000,4.99,8.7,0,4.99
"4457",4457,"Moonbase 332",19000,25000,6000,4.99,31.58,0,4.99
"4458",4458,"Gynophobia",23000,25000,2000,3.99,8.7,82,0.71
"4459",4459,"Insanity's Blade",23000,25000,2000,5.99,8.7,80,1.19
"4460",4460,"Atelier Firis: The Alchemist and the Mysterious Journey / フィリスのアトリエ ～不思議な旅の錬金術士～",18000,25000,7000,59.99,38.89,40,35.99
"4461",4461,"TransPlan",20000,25000,5000,2.99,25,60,1.19
"4462",4462,"Slayer Of Traitors",2000,25000,23000,0.99,1150,51,0.49
"4463",4463,"HyperRogue",21000,25000,4000,4.99,19.05,50,2.49
"4464",4464,"Endless Horde",23000,25000,2000,0.99,8.7,70,0.49
"4465",4465,"Rage Wars",19000,25000,6000,0.99,31.58,51,0.49
"4466",4466,"The Swindle",21000,25000,4000,14.99,19.05,66,5.09
"4467",4467,"Sprint Vector",15000,25000,10000,29.99,66.67,50,14.99
"4468",4468,"Caravan",19000,25000,6000,9.99,31.58,80,1.99
"4469",4469,"Cattails | Become a Cat!",19000,25000,6000,14.99,31.58,34,9.89
"4470",4470,"GET EVEN",21000,25000,4000,29.99,19.05,75,7.49
"4471",4471,"JASEM: Just Another Shooter with Electronic Music",6000,25000,19000,6.99,316.67,90,0.69
"4472",4472,"Mark of the Ninja: Remastered",0,25000,25000,19.99,0,15,16.99
"4473",4473,"Song of the Myrne: What Lies Beneath",14000,25000,11000,4.99,78.57,40,2.99
"4474",4474,"Goodnight Butcher",22000,25000,3000,1.99,13.64,0,1.99
"4475",4475,"Hocus Pocus",11000,25000,14000,4.99,127.27,50,2.49
"4476",4476,"YOU DON'T KNOW JACK Vol. 3",1000,25000,24000,2.99,2400,50,1.49
"4477",4477,"Cubic complex",23000,25000,2000,0.99,8.7,37,0.62
"4478",4478,"VTOL VR",13000,25000,12000,29.99,92.31,25,22.49
"4479",4479,"Strikey Sisters",11000,25000,14000,4.99,127.27,80,0.49
"4480",4480,"Z.A.R.",17000,25000,8000,5.99,47.06,80,1.19
"4481",4481,"Haunted",18000,25000,7000,14.99,38.89,50,7.49
"4482",4482,"Academagia: The Making of Mages",6000,25000,19000,15.99,316.67,55,7.19
"4483",4483,"YOU DON'T KNOW JACK Vol. 6 The Lost Gold",19000,25000,6000,1.99,31.58,50,0.99
"4484",4484,"The Weaponographist",20000,25000,5000,9.99,25,80,1.99
"4485",4485,"Braveland Wizard",21000,25000,4000,6.99,19.05,65,2.79
"4486",4486,"Chris Sawyer's Locomotion",22000,25000,3000,5.99,13.64,75,1.49
"4487",4487,"No Time To Live",21000,25000,4000,1.99,19.05,75,0.49
"4488",4488,"Tibetan Quest: Beyond the World's End",22000,25000,3000,9.99,13.64,70,2.99
"4489",4489,"We Are Legion",14000,25000,11000,9.99,78.57,0,9.99
"4490",4490,"Exiled Kingdoms",7000,25000,18000,7.99,257.14,25,5.99
"4491",4491,"Hot Mars 69",3000,24000,21000,0.99,700,51,0.49
"4492",4492,"Stairs",11000,24000,13000,12.99,118.18,85,1.94
"4493",4493,"Romance of the Three Kingdoms 11 with Power Up Kit / 三國志11 with パワーアップキット",10000,24000,14000,39.99,140,30,27.99
"4494",4494,"LifeGameSimulator",0,24000,24000,0.99,0,45,0.54
"4495",4495,"Abalone",13000,24000,11000,6.99,84.62,63,2.58
"4496",4496,"Power & Revolution",12000,24000,12000,49.99,100,25,37.49
"4497",4497,"Earth Overclocked",19000,24000,5000,9.99,26.32,90,0.99
"4498",4498,"Heileen 1: Sail Away",22000,24000,2000,5.99,9.09,75,1.49
"4499",4499,"Prospekt",22000,24000,2000,9.99,9.09,75,2.49
"4500",4500,"Demon Hunter 3: Revelation",21000,24000,3000,9.99,14.29,60,3.99
"4501",4501,"IMSCARED",21000,24000,3000,3.99,14.29,60,1.59
"4502",4502,"Bloody Streets",21000,24000,3000,4.99,14.29,80,0.99
"4503",4503,"Sonicomi",15000,24000,9000,34.99,60,50,17.49
"4504",4504,"Algotica Iterations",11000,24000,13000,6.99,118.18,75,2.09
"4505",4505,"The Walking Zombie: Dead City",19000,24000,5000,2.99,26.32,66,1.01
"4506",4506,"Not Tonight",0,24000,24000,19.99,0,25,14.99
"4507",4507,"The Legend of Candlewind: Nights & Candles",16000,24000,8000,9.99,50,90,0.99
"4508",4508,"Super Mega Baseball 2",14000,24000,10000,29.99,71.43,40,17.99
"4509",4509,"SOK",2000,24000,22000,1.99,1100,75,0.49
"4510",4510,"Ninja Guy",22000,24000,2000,1.99,9.09,0,1.99
"4511",4511,"Stone Flower",21000,24000,3000,1.99,14.29,75,0.49
"4512",4512,"Vektor Wars",22000,24000,2000,6.99,9.09,50,3.49
"4513",4513,"Age of Fear 2: The Chaos Lord GOLD",19000,24000,5000,19.99,26.32,80,3.99
"4514",4514,"Slip",22000,24000,2000,3.99,9.09,0,3.99
"4515",4515,"MX vs. ATV Supercross Encore",22000,24000,2000,29.99,9.09,75,7.49
"4516",4516,"Doodle Devil",17000,24000,7000,9.99,41.18,71,2.89
"4517",4517,"Lust for Darkness",11000,24000,13000,14.99,118.18,25,11.24
"4518",4518,"The Enchanted Cave 2",14000,24000,10000,9.99,71.43,42,5.79
"4519",4519,"Celestial Command",19000,24000,5000,10.99,26.32,25,8.24
"4520",4520,"Love in the Glen",17000,24000,7000,5.99,41.18,80,1.19
"4521",4521,"Spermination",22000,24000,2000,2.99,9.09,66,1.01
"4522",4522,"Panty Party",20000,24000,4000,9.99,20,50,4.99
"4523",4523,"BoomTown! Deluxe",22000,24000,2000,1.99,9.09,0,1.99
"4524",4524,"Cally's Trials",19000,24000,5000,6.99,26.32,80,1.39
"4525",4525,"Isbarah",18000,24000,6000,13.99,33.33,0,13.99
"4526",4526,"Days of War",19000,24000,5000,24.99,26.32,0,24.99
"4527",4527,"F-16 Multirole Fighter",6000,24000,18000,9.99,300,75,2.49
"4528",4528,"The Little Acre",21000,24000,3000,12.99,14.29,75,3.24
"4529",4529,"FAST BEAT LOOP RACER GT | 環狀賽車GT",12000,24000,12000,9.99,100,40,5.99
"4530",4530,"Space Explorers",13000,24000,11000,0.99,84.62,51,0.49
"4531",4531,"Spirit of War",20000,24000,4000,9.99,20,0,9.99
"4532",4532,"Ancient Guardian",11000,24000,13000,6.99,118.18,90,0.69
"4533",4533,"GearCity",20000,24000,4000,16.99,20,25,12.74
"4534",4534,"MiG-29 Fulcrum",6000,24000,18000,9.99,300,75,2.49
"4535",4535,"Townsmen",17000,24000,7000,11.99,41.18,60,4.79
"4536",4536,"ChargeShot",22000,24000,2000,9.99,9.09,66,3.39
"4537",4537,"The Chosen Warriors",18000,24000,6000,6.99,33.33,50,3.49
"4538",4538,"Redline",22000,24000,2000,6.99,9.09,75,1.74
"4539",4539,"Street Fighter 30th Anniversary Collection",15000,24000,9000,39.99,60,25,29.99
"4540",4540,"Memento Mori 2",20000,24000,4000,24.99,20,80,4.99
"4541",4541,"BREAK ARTS II",12000,24000,12000,14.99,100,34,9.89
"4542",4542,"SinaRun",9000,24000,15000,2.99,166.67,25,2.24
"4543",4543,"Beans: The Coffee Shop Simulator",20000,24000,4000,4.99,20,0,4.99
"4544",4544,"懒人修仙传",0,24000,24000,3.99,0,20,3.19
"4545",4545,"Defense Zone 3 Ultra HD",8000,24000,16000,3.99,200,20,2.39
"4546",4546,"Crimson Memories",9000,24000,15000,1.99,166.67,70,0.59
"4547",4547,"Pang Adventures",21000,24000,3000,9.99,14.29,50,4.99
"4548",4548,"In Celebration of Violence",18000,24000,6000,7.99,33.33,75,1.99
"4549",4549,"Silver",13000,24000,11000,5.99,84.62,67,1.97
"4550",4550,"Jet Car Stunts",22000,24000,2000,2.99,9.09,67,0.98
"4551",4551,"夏花的轨迹——A summer promise to forever",14000,24000,10000,1.99,71.43,40,1.19
"4552",4552,"ATOMEGA",21000,24000,3000,9.99,14.29,70,2.99
"4553",4553,"TY the Tasmanian Tiger 4",18000,24000,6000,5.99,33.33,75,1.49
"4554",4554,"conNEcT01",0,24000,24000,0.99,0,0,0.99
"4555",4555,"TRISTOY",22000,24000,2000,6.99,9.09,80,1.39
"4556",4556,"ATOM RPG: Post-apocalyptic indie game",11000,24000,13000,14.99,118.18,10,13.49
"4557",4557,"红石遗迹 - Red Obsidian Remnant",20000,24000,4000,8.99,20,40,5.39
"4558",4558,"Bunny Hop League",19000,24000,5000,5.99,26.32,33,4.01
"4559",4559,"Leap of Fate",20000,24000,4000,15.99,20,70,4.79
"4560",4560,"Legend of Himari",10000,24000,14000,0.99,140,45,0.54
"4561",4561,"The Talos Principle VR",22000,24000,2000,39.99,9.09,66,13.59
"4562",4562,"1849",22000,24000,2000,14.99,9.09,70,4.49
"4563",4563,"Typoman",16000,24000,8000,9.99,50,70,2.99
"4564",4564,"Not without my donuts",20000,24000,4000,3.99,20,87,0.51
"4565",4565,"Dandelion - Wishes brought to you -",21000,24000,3000,29.99,14.29,33,20.09
"4566",4566,"Super Chain Crusher Horizon",22000,24000,2000,14.99,9.09,80,2.99
"4567",4567,"Home Wars",20000,24000,4000,9.99,20,50,4.99
"4568",4568,"Epic Quest of the 4 Crystals",22000,24000,2000,9.99,9.09,90,0.99
"4569",4569,"Party Hard 2",1000,24000,23000,19.99,2300,10,17.99
"4570",4570,"Airport Madness 3D",11000,24000,13000,19.99,118.18,50,9.99
"4571",4571,"Moss",20000,24000,4000,29.99,20,34,19.79
"4572",4572,"Mini Thief",21000,24000,3000,3.99,14.29,50,1.99
"4573",4573,"Escape The Lost Kingdom: The Forgotten Pharaoh",22000,24000,2000,4.99,9.09,90,0.49
"4574",4574,"Rogue State",22000,24000,2000,12.99,9.09,80,2.59
"4575",4575,"A Vampyre Story",20000,24000,4000,19.99,20,90,1.99
"4576",4576,"Spiny Adventures",20000,24000,4000,0.99,20,51,0.49
"4577",4577,"Earthtongue",13000,24000,11000,4.99,84.62,75,1.24
"4578",4578,"BANZAI PECAN: The Last Hope For the Young Century",20000,24000,4000,2.99,20,0,2.99
"4579",4579,"Nature Calls",9000,24000,15000,6.99,166.67,40,4.19
"4580",4580,"Desert Law",19000,24000,5000,2.99,26.32,77,0.68
"4581",4581,"Kings of Kung Fu",21000,23000,2000,9.99,9.52,90,0.99
"4582",4582,"War of Rights",5000,23000,18000,29.99,360,0,29.99
"4583",4583,"Zima uhodi!",13000,23000,10000,0.99,76.92,30,0.69
"4584",4584,"Crappy Day Enhanced Edition",8000,23000,15000,0.99,187.5,51,0.49
"4585",4585,"Astro Emporia",20000,23000,3000,0.99,15,51,0.49
"4586",4586,"Empire of the Dead Souls",2000,23000,21000,0.99,1050,51,0.49
"4587",4587,"Chowderchu",17000,23000,6000,2.99,35.29,50,1.49
"4588",4588,"Spy Fox In: Hold the Mustard",14000,23000,9000,4.99,64.29,60,1.99
"4589",4589,"Nimble Writer",12000,23000,11000,9.99,91.67,30,6.99
"4590",4590,"女装妹妹从没少过麻烦",15000,23000,8000,1.99,53.33,50,0.99
"4591",4591,"Kick-Ass 2",16000,23000,7000,19.99,43.75,75,4.99
"4592",4592,"Predator Simulator",19000,23000,4000,7.99,21.05,40,1.79
"4593",4593,"Ultimate Space Commando",13000,23000,10000,9.99,76.92,75,2.49
"4594",4594,"Void And Meddler",21000,23000,2000,3.99,9.52,80,0.79
"4595",4595,"A Golden Wake",20000,23000,3000,9.99,15,75,2.49
"4596",4596,"Parkasaurus",0,23000,23000,19.99,0,0,19.99
"4597",4597,"Fictorum",7000,23000,16000,19.99,228.57,50,9.99
"4598",4598,"Scott in Space",20000,23000,3000,4.99,15,0,4.99
"4599",4599,"WARTILE",20000,23000,3000,19.99,15,40,11.99
"4600",4600,"The Banner Saga 3",0,23000,23000,24.99,0,30,17.49
"4601",4601,"东方大战争 ~ Touhou Big Big Battle",0,23000,23000,5.99,0,30,4.19
"4602",4602,"Mega Man X Legacy Collection / ロックマンX アニバーサリー コレクション",0,23000,23000,19.99,0,25,14.99
"4603",4603,"Rolling Line",14000,23000,9000,16.99,64.29,20,11.19
"4604",4604,"Planet Driller",18000,23000,5000,1.99,27.78,75,0.49
"4605",4605,"Tomb of Tyrants",16000,23000,7000,7.99,43.75,70,2.39
"4606",4606,"False Shelter",11000,23000,12000,0.99,109.09,51,0.49
"4607",4607,"Infinite Space III: Sea of Stars",20000,23000,3000,9.99,15,80,1.99
"4608",4608,"Brawlout",21000,23000,2000,19.99,9.52,75,4.99
"4609",4609,"Asura: Vengeance Expansion",19000,23000,4000,9.99,21.05,50,4.99
"4610",4610,"Visitor 来访者",0,23000,23000,3.99,0,25,2.99
"4611",4611,"Obliteracers",8000,23000,15000,14.99,187.5,65,5.24
"4612",4612,"Hack RUN",16000,23000,7000,2.99,43.75,75,0.74
"4613",4613,"YOU DON'T KNOW JACK TELEVISION",1000,23000,22000,2.99,2200,50,1.49
"4614",4614,"Dungeonmans",21000,23000,2000,14.99,9.52,66,5.09
"4615",4615,"Lamia's Game Room",17000,23000,6000,0.99,35.29,51,0.49
"4616",4616,"D&D Lords of Waterdeep",15000,23000,8000,14.99,53.33,50,7.49
"4617",4617,"Adventures of Robinson Crusoe",21000,23000,2000,9.99,9.52,60,3.99
"4618",4618,"The Frostrune",15000,23000,8000,9.99,53.33,75,2.49
"4619",4619,"Maelstrom",20000,23000,3000,19.99,15,25,14.99
"4620",4620,"Pipes!",6000,23000,17000,1.99,283.33,75,0.49
"4621",4621,"Hammer 2",15000,23000,8000,4.99,53.33,90,0.49
"4622",4622,"Demon Hunter 2: New Chapter",21000,23000,2000,9.99,9.52,70,2.99
"4623",4623,"Moonstone Tavern - A Fantasy Tavern Sim!",21000,23000,2000,7.99,9.52,80,1.59
"4624",4624,"Hero of Many",15000,23000,8000,6.99,53.33,0,6.99
"4625",4625,"Mages of Mystralia",17000,23000,6000,19.99,35.29,50,9.99
"4626",4626,"Tactical Soccer The New Season",12000,23000,11000,9.99,91.67,90,0.99
"4627",4627,"Ancients of Ooga",18000,23000,5000,9.99,27.78,0,9.99
"4628",4628,"The Signal From Tölva",16000,23000,7000,19.99,43.75,75,4.99
"4629",4629,"Gratuitous Space Battles 2",19000,23000,4000,9.99,21.05,75,2.49
"4630",4630,"Days Under Custody",19000,23000,4000,4.99,21.05,90,0.49
"4631",4631,"Stick 'Em Up 2: Paper Adventures",10000,23000,13000,2.99,130,67,0.98
"4632",4632,"Attack on Titan 2 - A.O.T.2 - 進撃の巨人２",12000,23000,11000,59.99,91.67,30,41.99
"4633",4633,"Tetropunk",14000,23000,9000,2.99,64.29,75,0.74
"4634",4634,"Stoire",19000,23000,4000,4.99,21.05,45,1.09
"4635",4635,"BOOBS BATTLEGROUND",2000,23000,21000,0.99,1050,51,0.49
"4636",4636,"Harvest Moon: Light of Hope Special Edition",12000,23000,11000,19.99,91.67,50,9.99
"4637",4637,"GUILTY GEAR 2 -OVERTURE-",17000,23000,6000,19.99,35.29,80,3.99
"4638",4638,"Zero Escape: The Nonary Games",18000,23000,5000,44.99,27.78,40,26.99
"4639",4639,"Tank Rush",1000,23000,22000,0.99,2200,45,0.54
"4640",4640,"RollerCoaster Tycoon Classic",21000,23000,2000,19.99,9.52,50,9.99
"4641",4641,"The Bunker",17000,23000,6000,12.99,35.29,40,7.79
"4642",4642,"Beach Restaurant",4000,23000,19000,0.99,475,51,0.49
"4643",4643,"Pro Cycling Manager 2018",0,23000,23000,39.99,0,50,19.99
"4644",4644,"Camp Sunshine",15000,23000,8000,4.99,53.33,90,0.49
"4645",4645,"Gardens Inc. – From Rakes to Riches",14000,23000,9000,9.99,64.29,60,3.99
"4646",4646,"Sword Art Online Re: Hollow Fragment",0,23000,23000,19.99,0,50,9.99
"4647",4647,"Bud Spencer & Terence Hill - Slaps And Beans",18000,23000,5000,19.99,27.78,50,9.99
"4648",4648,"Silent Service 2",18000,23000,5000,6.99,27.78,75,1.74
"4649",4649,"Curse: The Eye of Isis",17000,23000,6000,2.99,35.29,70,0.89
"4650",4650,"Andarilho",18000,23000,5000,0.99,27.78,75,0.49
"4651",4651,"Sapper boom!",2000,23000,21000,0.99,1050,45,0.54
"4652",4652,"ConflictCraft",21000,23000,2000,2.99,9.52,75,0.74
"4653",4653,"Battle Dome",17000,23000,6000,9.99,35.29,90,1.49
"4654",4654,"OVRdrop",8000,23000,15000,14.99,187.5,30,10.49
"4655",4655,"NOBUNAGA’S AMBITION: Kakushin with Power Up Kit / 信長の野望・革新 with パワーアップキット",8000,23000,15000,54.99,187.5,50,27.49
"4656",4656,"Thief Town",19000,23000,4000,7.99,21.05,75,1.99
"4657",4657,"THE LAST BLADE",19000,23000,4000,9.99,21.05,50,4.99
"4658",4658,"Perfect Fit - Totemland",3000,22000,19000,3.99,633.33,0,3.99
"4659",4659,"MadSpace: To Hell and Beyond",8000,22000,14000,5.99,175,80,1.19
"4660",4660,"Hexus",18000,22000,4000,4.99,22.22,80,0.99
"4661",4661,"Solar Shifter EX",20000,22000,2000,4.99,10,60,1.99
"4662",4662,"My Lovely Daughter",15000,22000,7000,14.99,46.67,30,10.49
"4663",4663,"Orbital X",18000,22000,4000,2.99,22.22,0,2.99
"4664",4664,"Simmiland",0,22000,22000,4.99,0,0,4.99
"4665",4665,"G-DINO'S JUNGLE ADVENTURE",3000,22000,19000,0.99,633.33,51,0.49
"4666",4666,"魔物讨伐团",0,22000,22000,12.99,0,25,9.74
"4667",4667,"PIXEL ZUMBI",1000,22000,21000,0.99,2100,51,0.49
"4668",4668,"World Inside Out",8000,22000,14000,1.99,175,75,0.49
"4669",4669,"The Life Of Greather",18000,22000,4000,1.99,22.22,75,0.49
"4670",4670,"ARAYA",16000,22000,6000,14.99,37.5,65,5.24
"4671",4671,"Love at First Sight",20000,22000,2000,9.99,10,75,2.49
"4672",4672,"Combat Raccoon",17000,22000,5000,1.99,29.41,75,0.49
"4673",4673,"Kiai Resonance",19000,22000,3000,4.99,15.79,85,0.74
"4674",4674,"MANIC MINERS",20000,22000,2000,2.99,10,50,1.49
"4675",4675,"ASTRAL",0,22000,22000,9.99,0,40,5.99
"4676",4676,"FORM",14000,22000,8000,14.99,57.14,50,7.49
"4677",4677,"Les Fleursword",9000,22000,13000,1.99,144.44,70,0.59
"4678",4678,"PUSH",17000,22000,5000,0.99,29.41,20,0.79
"4679",4679,"DoDonPachi Resurrection",16000,22000,6000,29.99,37.5,50,14.99
"4680",4680,"BlastZone 2",19000,22000,3000,9.99,15.79,67,0.98
"4681",4681,"YOU DON'T KNOW JACK MOVIES",1000,22000,21000,2.99,2100,50,1.49
"4682",4682,"Rise of Liberty",17000,22000,5000,7.99,29.41,40,4.79
"4683",4683,"Kindred Spirits on the Roof",19000,22000,3000,34.99,15.79,50,17.49
"4684",4684,"MY HERO ONE'S JUSTICE",0,22000,22000,59.99,0,0,59.99
"4685",4685,"Armored Fist 3",5000,22000,17000,9.99,340,75,2.49
"4686",4686,"Multibombers",0,22000,22000,4.99,0,20,3.99
"4687",4687,"Ride 'em Low",20000,22000,2000,2.99,10,70,0.89
"4688",4688,"Pool of Death",16000,22000,6000,3.99,37.5,0,3.99
"4689",4689,"A Bastard's Tale",18000,22000,4000,4.99,22.22,70,1.49
"4690",4690,"Shenmue I & II",0,22000,22000,29.99,0,10,26.99
"4691",4691,"Vlad the Impaler",20000,22000,2000,0.99,10,0,0.99
"4692",4692,"Hobo: Tough Life",16000,22000,6000,18.99,37.5,25,14.24
"4693",4693,"Lord of the Dark Castle",9000,22000,13000,3.99,144.44,0,3.99
"4694",4694,"Birthdays the Beginning / バースデイズ・ザ・ビギニング",17000,22000,5000,39.99,29.41,75,9.99
"4695",4695,"Echelon",19000,22000,3000,3.99,15.79,88,0.49
"4696",4696,"SINISTRY SILINIUM",20000,22000,2000,4.99,10,90,0.49
"4697",4697,"Near Death",18000,22000,4000,14.99,22.22,80,2.99
"4698",4698,"Feel-A-Maze",16000,22000,6000,4.99,37.5,90,0.49
"4699",4699,"Constant C",9000,22000,13000,9.99,144.44,0,9.99
"4700",4700,"Daedalus - No Escape",20000,22000,2000,4.99,10,80,0.99
"4701",4701,"Robinson Crusoe and the Cursed Pirates",7000,22000,15000,9.99,214.29,60,3.99
"4702",4702,"John, The Zombie",10000,22000,12000,9.99,120,80,1.99
"4703",4703,"Cyborg Invasion Shooter 2: Battle Of Earth",3000,22000,19000,1.99,633.33,75,0.49
"4704",4704,"Figment",10000,22000,12000,19.99,120,52,9.59
"4705",4705,"Survisland",0,22000,22000,8.99,0,0,6.99
"4706",4706,"GIBZ",13000,22000,9000,7.99,69.23,65,2.79
"4707",4707,"Blacksea Odyssey",19000,22000,3000,9.99,15.79,50,4.99
"4708",4708,"High Hell",14000,22000,8000,9.99,57.14,75,2.49
"4709",4709,"7 Billion Humans",0,22000,22000,14.99,0,0,14.99
"4710",4710,"Gunslugs",19000,22000,3000,4.99,15.79,80,0.99
"4711",4711,"Shadows: Awakening",0,22000,22000,39.99,0,35,25.99
"4712",4712,"Tequila Zombies 3",18000,22000,4000,2.99,22.22,84,0.49
"4713",4713,"Always The Same Blue Sky...",19000,22000,3000,2.99,15.79,30,2.09
"4714",4714,"Omensight: Definitive Edition",12000,22000,10000,19.99,83.33,20,15.99
"4715",4715,"Cladun X2 / クラシックダンジョンX2",19000,22000,3000,9.99,15.79,75,2.49
"4716",4716,"Joe's Diner",18000,22000,4000,7.99,22.22,70,2.39
"4717",4717,"BloodNet",20000,22000,2000,6.99,10,75,1.74
"4718",4718,"VR Dungeon Knight",14000,22000,8000,19.99,57.14,25,14.99
"4719",4719,"Fallen: A2P Protocol",20000,22000,2000,9.99,10,0,9.99
"4720",4720,"First Strike: Final Hour",20000,22000,2000,11.99,10,75,2.99
"4721",4721,"Snowball!",10000,22000,12000,2.99,120,75,0.74
"4722",4722,"Top Hat",20000,22000,2000,0.99,10,0,0.99
"4723",4723,"MXGP3 - The Official Motocross Videogame",17000,22000,5000,39.99,29.41,75,9.99
"4724",4724,"Copter and Sky",10000,22000,12000,4.99,120,60,1.99
"4725",4725,"Red Goblin: Cursed Forest",16000,22000,6000,4.99,37.5,90,0.49
"4726",4726,"Blockscape",20000,22000,2000,9.99,10,25,7.49
"4727",4727,"Unavowed",0,22000,22000,14.99,0,15,12.74
"4728",4728,"Axes and Arrows",11000,22000,11000,2.99,100,0,2.99
"4729",4729,"Miracle Fly",18000,22000,4000,7.99,22.22,70,2.39
"4730",4730,"Drive to Hell",18000,22000,4000,4.99,22.22,60,1.99
"4731",4731,"Duke Grabowski, Mighty Swashbuckler",7000,22000,15000,1.99,214.29,50,0.99
"4732",4732,"Twisted Lands Trilogy: Collector's Edition",12000,22000,10000,19.99,83.33,75,4.99
"4733",4733,"VR The Diner Duo",16000,22000,6000,14.99,37.5,50,7.49
"4734",4734,"Slice, Dice & Rice",8000,22000,14000,9.99,175,80,1.99
"4735",4735,"Robot Legions Reborn",18000,22000,4000,1.99,22.22,50,0.99
"4736",4736,"IN-VERT",17000,22000,5000,2.99,29.41,66,1.01
"4737",4737,"Airport Firefighters - The Simulation",20000,22000,2000,14.99,10,60,5.99
"4738",4738,"Anode",12000,22000,10000,3.99,83.33,60,1.59
"4739",4739,"Criminal Girls: Invite Only / クリミナルガールズ INVITATION",19000,22000,3000,19.99,15.79,60,7.99
"4740",4740,"Hail to the King: Deathbat",8000,22000,14000,5.99,175,0,5.99
"4741",4741,"Darklands",20000,22000,2000,6.99,10,75,1.74
"4742",4742,"4x4 Dream Race",19000,22000,3000,4.99,15.79,90,0.49
"4743",4743,"Boobs Saga",0,22000,22000,2.99,0,20,2.39
"4744",4744,"Disney•Pixar Toy Story 3: The Video Game",18000,21000,3000,19.99,16.67,65,6.99
"4745",4745,"Salty Fish Go!",19000,21000,2000,0.99,10.53,30,0.69
"4746",4746,"Catch a Lover",13000,21000,8000,6.99,61.54,25,5.24
"4747",4747,"Choice of the Deathless",19000,21000,2000,4.99,10.53,40,2.99
"4748",4748,"Supreme Ruler The Great War",6000,21000,15000,19.99,250,60,7.99
"4749",4749,"Jack Nicklaus Perfect Golf",17000,21000,4000,34.99,23.53,0,34.99
"4750",4750,"Banzai Escape",15000,21000,6000,5.99,40,80,1.19
"4751",4751,"VODKA",11000,21000,10000,0.99,90.91,33,0.66
"4752",4752,"Train Mechanic Simulator 2017",13000,21000,8000,14.99,61.54,80,2.99
"4753",4753,"Typefighters (Steam Edition)",18000,21000,3000,1.99,16.67,50,0.99
"4754",4754,"Pajama Sam 2: Thunder And Lightning Aren't So Frightening",9000,21000,12000,6.99,133.33,60,2.79
"4755",4755,"Displaced",9000,21000,12000,5.99,133.33,90,0.59
"4756",4756,"Knights Hunt",9000,21000,12000,4.99,133.33,90,0.49
"4757",4757,"Ghost Town Mine Ride & Shootin' Gallery",14000,21000,7000,8.99,50,25,6.74
"4758",4758,"Braveland Pirate",19000,21000,2000,8.99,10.53,60,3.59
"4759",4759,"Fort Meow",13000,21000,8000,7.99,61.54,80,1.59
"4760",4760,"Titanfall - The Final Hours",18000,21000,3000,0.99,16.67,51,0.49
"4761",4761,"UNDER NIGHT IN-BIRTH Exe:Late[st]",0,21000,21000,39.99,0,10,35.99
"4762",4762,"Beerman",10000,21000,11000,1.99,110,75,0.49
"4763",4763,"Dead In Vinland",14000,21000,7000,19.99,50,25,14.99
"4764",4764,"Dominions 5 - Warriors of the Faith",18000,21000,3000,39.99,16.67,30,27.99
"4765",4765,"Peak Angle: Drift Online",18000,21000,3000,7.99,16.67,37,5.03
"4766",4766,"Omega One",18000,21000,3000,8.99,16.67,90,0.89
"4767",4767,"Knee Deep",19000,21000,2000,19.99,10.53,60,7.99
"4768",4768,"Zoop! - Hunter's Grimm",15000,21000,6000,1.99,40,75,0.49
"4769",4769,"Thorne - Death Merchants",14000,21000,7000,3.99,50,88,0.49
"4770",4770,"OPUS: The Day We Found Earth",11000,21000,10000,8.99,90.91,60,3.59
"4771",4771,"Soldiers Lost Forever (1914-1918)",0,21000,21000,2.99,0,40,1.79
"4772",4772,"Skautfold: Shrouded in Sanity",13000,21000,8000,4.99,61.54,75,1.24
"4773",4773,"Cart Racer",15000,21000,6000,0.99,40,51,0.49
"4774",4774,"Millennium 4 - Beyond Sunset",18000,21000,3000,5.99,16.67,90,0.59
"4775",4775,"Hatsune Miku VR / 初音ミク VR",9000,21000,12000,24.99,133.33,30,17.49
"4776",4776,"D'LIRIUM",10000,21000,11000,1.99,110,75,0.49
"4777",4777,"Shift Happens",18000,21000,3000,14.99,16.67,45,8.24
"4778",4778,"Luxor 2",11000,21000,10000,9.99,90.91,60,3.99
"4779",4779,"Door Kickers: Action Squad",9000,21000,12000,13.99,133.33,20,10.79
"4780",4780,"Sorry, James",17000,21000,4000,4.99,23.53,50,2.49
"4781",4781,"Artifact Adventure",13000,21000,8000,6.99,61.54,60,2.79
"4782",4782,"Bayou Island - Point and Click Adventure",14000,21000,7000,1.99,50,70,0.59
"4783",4783,"MachiaVillain",11000,21000,10000,19.99,90.91,40,11.99
"4784",4784,"UnReal World",17000,21000,4000,10.99,23.53,20,8.79
"4785",4785,"Adventures of Pip",16000,21000,5000,14.99,31.25,60,5.99
"4786",4786,"Orc Attack: Flatulent Rebellion",19000,21000,2000,9.99,10.53,90,0.99
"4787",4787,"Journal",19000,21000,2000,9.99,10.53,80,1.99
"4788",4788,"The Lord of the Rings: Living Card Game",0,21000,21000,7.99,0,0,7.99
"4789",4789,"寄居隅怪奇事件簿 Hermitage Strange Case Files",0,21000,21000,13.99,0,5,13.29
"4790",4790,"Abyss Cave",1000,21000,20000,6.99,2000,13,2.99
"4791",4791,"Treasure Hunter Claire",0,21000,21000,19.99,0,30,13.99
"4792",4792,"The Dishwasher: Vampire Smile",16000,21000,5000,9.99,31.25,50,4.99
"4793",4793,"Avoid - Sensory Overload",18000,21000,3000,4.99,16.67,90,0.49
"4794",4794,"PCMark 10",11000,21000,10000,29.99,90.91,85,4.49
"4795",4795,"Vietnam ‘65",19000,21000,2000,9.99,10.53,51,4.89
"4796",4796,"NaziShootout",2000,21000,19000,0.99,950,51,0.49
"4797",4797,"Streets of Fury EX",14000,21000,7000,9.99,50,60,3.99
"4798",4798,"STANDBY",19000,21000,2000,7.99,10.53,75,1.99
"4799",4799,"Procyon",18000,21000,3000,3.99,16.67,0,3.99
"4800",4800,"Last Heroes",14000,21000,7000,2.99,50,83,0.5
"4801",4801,"Robo Do It",17000,21000,4000,0.99,23.53,66,0.49
"4802",4802,"Princess Isabella: The Rise of an Heir",16000,21000,5000,9.99,31.25,70,2.99
"4803",4803,"Crazy Alien",18000,21000,3000,0.99,16.67,51,0.49
"4804",4804,"Splasher",17000,21000,4000,14.99,23.53,50,7.49
"4805",4805,"Fidel Dungeon Rescue",17000,21000,4000,9.99,23.53,50,4.99
"4806",4806,"Root Of Evil: The Tailor",16000,21000,5000,6.99,31.25,75,1.74
"4807",4807,"Perils of Man",10000,21000,11000,9.99,110,90,0.99
"4808",4808,"60 Parsecs!",0,21000,21000,14.99,0,25,11.24
"4809",4809,"NeXus: One Core",16000,21000,5000,4.99,31.25,0,4.99
"4810",4810,"Brushwood Buddies",14000,21000,7000,2.99,50,80,0.59
"4811",4811,"Mad Dojo",10000,21000,11000,4.99,110,30,3.49
"4812",4812,"Fresh Body",19000,21000,2000,9.99,10.53,50,4.99
"4813",4813,"Wobbly Jungle",8000,21000,13000,1.99,162.5,70,0.59
"4814",4814,"Zombie Solitaire",18000,21000,3000,8.99,16.67,70,2.69
"4815",4815,"City Climber",14000,21000,7000,6.99,50,70,2.09
"4816",4816,"Agent Walker: Secret Journey",14000,21000,7000,9.99,50,70,2.99
"4817",4817,"Space Legends: At the Edge of the Universe",18000,21000,3000,9.99,16.67,75,2.49
"4818",4818,"ALPAGES : THE FIVE BOOKS",15000,21000,6000,0.99,40,51,0.49
"4819",4819,"Eradicator",17000,21000,4000,6.99,23.53,75,1.74
"4820",4820,"In Death",12000,21000,9000,29.99,75,50,12.99
"4821",4821,"Big Journey to Home",12000,21000,9000,2.99,75,70,0.89
"4822",4822,"Weird Dungeon Explorer: Run Away",3000,21000,18000,0.99,600,51,0.49
"4823",4823,"Governor of Poker 2",19000,21000,2000,7.99,10.53,0,7.99
"4824",4824,"Monstro: Battle Tactics",10000,21000,11000,5.99,110,60,2.39
"4825",4825,"Royal Heroes",15000,21000,6000,4.99,40,75,1.24
"4826",4826,"You, With Me - A Kinetic Novel",17000,21000,4000,2.99,23.53,50,1.49
"4827",4827,"qop",16000,21000,5000,0.99,31.25,40,0.59
"4828",4828,"God of Word",17000,20000,3000,4.99,17.65,33,3.34
"4829",4829,"Prophour23",18000,20000,2000,9.99,11.11,75,2.49
"4830",4830,"Wildlife Park 2 - Marine World",18000,20000,2000,3.99,11.11,33,2.67
"4831",4831,"Train Valley 2",16000,20000,4000,9.99,25,10,8.99
"4832",4832,"Zombie Wars: Invasion",17000,20000,3000,2.99,17.65,0,2.99
"4833",4833,"YOU DON'T KNOW JACK HEADRUSH",1000,20000,19000,2.99,1900,50,1.49
"4834",4834,"AngerForce: Reloaded",10000,20000,10000,9.99,100,55,4.49
"4835",4835,"A Good Snowman Is Hard To Build",7000,20000,13000,9.99,185.71,70,2.99
"4836",4836,"Overfall",17000,20000,3000,14.99,17.65,75,3.74
"4837",4837,"Clumsy Chef",15000,20000,5000,4.99,33.33,90,0.5
"4838",4838,"Pharaonic",15000,20000,5000,14.99,33.33,75,3.74
"4839",4839,"DESYNC",12000,20000,8000,14.99,66.67,70,4.49
"4840",4840,"Kingdom Two Crowns",0,20000,20000,19.99,0,0,19.99
"4841",4841,"Unexplored",13000,20000,7000,9.99,53.85,33,6.69
"4842",4842,"Forest Harvester Simulator",4000,20000,16000,6.99,400,60,2.79
"4843",4843,"Space Rangers: Quest",11000,20000,9000,9.99,81.82,80,1.99
"4844",4844,"Drifter",10000,20000,10000,11.99,100,40,7.19
"4845",4845,"Slash It Ultimate",11000,20000,9000,4.99,81.82,90,0.49
"4846",4846,"Sora",15000,20000,5000,8.99,33.33,50,4.49
"4847",4847,"Narcosis",17000,20000,3000,19.99,17.65,66,6.79
"4848",4848,"Electroquest: Resistance is Futile",6000,20000,14000,3.99,233.33,75,0.99
"4849",4849,"Way of Gold and Steel",18000,20000,2000,8.99,11.11,85,1.34
"4850",4850,"Goliath",18000,20000,2000,11.99,11.11,50,5.99
"4851",4851,"Chicken Invaders 3",10000,20000,10000,4.99,100,50,2.49
"4852",4852,"The Aquatic Adventure of the Last Human",15000,20000,5000,9.99,33.33,90,0.99
"4853",4853,"VirtualHere For Steam Link",18000,20000,2000,13.99,11.11,0,11.99
"4854",4854,"WonderCat Adventures",7000,20000,13000,2.99,185.71,30,2.09
"4855",4855,"GameMaker Studio 2 Desktop",15000,20000,5000,99.99,33.33,33,66.99
"4856",4856,"Putt-Putt and Fatty Bear's Activity Pack",18000,20000,2000,4.99,11.11,60,1.99
"4857",4857,"RPG Maker 2000",16000,20000,4000,24.99,25,80,4.99
"4858",4858,"Descent 3",14000,20000,6000,9.99,42.86,66,3.39
"4859",4859,"Baobabs Mausoleum Ep.1: Ovnifagos Don´t Eat Flamingos",16000,20000,4000,2.99,25,50,1.49
"4860",4860,"Kombine",18000,20000,2000,0.99,11.11,51,0.49
"4861",4861,"Ball of Wonder",17000,20000,3000,2.99,17.65,30,2.09
"4862",4862,"YOU DON'T KNOW JACK SPORTS",1000,20000,19000,2.99,1900,50,1.49
"4863",4863,"Midnight Mysteries: Witches of Abraham - Collector's Edition",18000,20000,2000,13.99,11.11,60,5.59
"4864",4864,"Red Johnson's Chronicles - 1+2 - Steam Special Edition",13000,20000,7000,9.99,53.85,70,2.99
"4865",4865,"Premium Pool Arena",14000,20000,6000,9.99,42.86,80,1.99
"4866",4866,"Driftland: The Magic Revival",14000,20000,6000,19.99,42.86,20,15.99
"4867",4867,"Heroes of Hellas 3: Athens",18000,20000,2000,2.99,11.11,65,1.04
"4868",4868,"Message Quest",16000,20000,4000,2.99,25,50,1.49
"4869",4869,"New Retro Arcade: Neon",17000,20000,3000,19.99,17.65,35,12.99
"4870",4870,"Visage",0,20000,20000,24.99,0,20,19.99
"4871",4871,"Motte Island",14000,20000,6000,4.99,42.86,0,4.99
"4872",4872,"3030 Deathwar Redux - A Space Odyssey",14000,20000,6000,14.99,42.86,50,7.49
"4873",4873,"H.E.",0,20000,20000,0.99,0,45,0.54
"4874",4874,"Chicken Assassin: Reloaded",16000,20000,4000,4.99,25,30,3.49
"4875",4875,"NitroRage",5000,20000,15000,4.99,300,0,4.99
"4876",4876,"Countryballs: Over The World",5000,20000,15000,1.99,300,75,0.49
"4877",4877,"Samurai Gunn",17000,20000,3000,14.99,17.65,0,14.99
"4878",4878,"Lydia",7000,20000,13000,4.99,185.71,80,0.99
"4879",4879,"ENKI",18000,20000,2000,4.99,11.11,90,0.49
"4880",4880,"RollingBall",2000,20000,18000,0.99,900,40,0.59
"4881",4881,"Hooligan Vasja: Halloween",13000,20000,7000,0.99,53.85,51,0.49
"4882",4882,"Centauri Sector",11000,20000,9000,4.99,81.82,50,2.49
"4883",4883,"Ninja Blade",18000,20000,2000,9.99,11.11,0,9.99
"4884",4884,"The Hive",17000,20000,3000,9.99,17.65,50,4.99
"4885",4885,"Red Game Without A Great Name",18000,20000,2000,2.99,11.11,70,0.89
"4886",4886,"INFRA",16000,20000,4000,29.99,25,66,10.19
"4887",4887,"Lumber Island - That Special Place",18000,20000,2000,4.99,11.11,60,1.99
"4888",4888,"Misao: Definitive Edition",15000,20000,5000,4.99,33.33,40,2.99
"4889",4889,"Beasts Battle",18000,20000,2000,1.99,11.11,30,1.39
"4890",4890,"Rocketbirds 2 Evolution",18000,20000,2000,9.99,11.11,50,4.99
"4891",4891,"Ookibloks",16000,20000,4000,1.99,25,50,0.99
"4892",4892,"Demolish & Build 2018",9000,20000,11000,19.99,122.22,45,10.99
"4893",4893,"GunWorld",18000,20000,2000,1.99,11.11,0,1.99
"4894",4894,"CapRiders: Euro Soccer",2000,20000,18000,3.99,900,0,3.99
"4895",4895,"Sparkle 2",11000,20000,9000,7.99,81.82,75,1.99
"4896",4896,"Hero of the Kingdom III",0,20000,20000,9.99,0,15,8.49
"4897",4897,"Living Legends: The Frozen Fear Collection",12000,20000,8000,19.99,66.67,50,9.99
"4898",4898,"Return to Krondor",18000,20000,2000,5.99,11.11,67,1.97
"4899",4899,"Gun Club VR",5000,20000,15000,19.99,300,50,9.99
"4900",4900,"Insane Road",16000,20000,4000,3.99,25,87,0.51
"4901",4901,"Rise of Insanity",10000,20000,10000,9.99,100,51,4.89
"4902",4902,"Millennium 5 - The Battle of the Millennium",14000,20000,6000,9.99,42.86,90,0.99
"4903",4903,"Thirsty Bubble",1000,20000,19000,0.99,1900,51,0.49
"4904",4904,"Mosaics Galore 2",0,20000,20000,4.99,0,90,0.49
"4905",4905,"March of the Living",14000,20000,6000,14.99,42.86,69,4.64
"4906",4906,"HordeZ",18000,20000,2000,16.99,11.11,65,5.94
"4907",4907,"Little Big Adventure 2",16000,20000,4000,3.99,25,50,1.99
"4908",4908,"The Silver Case",14000,20000,6000,19.99,42.86,60,7.99
"4909",4909,"The Secret Of Hildegards",16000,19000,3000,2.99,18.75,75,0.74
"4910",4910,"Venusian Vengeance",12000,19000,7000,3.99,58.33,87,0.51
"4911",4911,"Mu Cartographer",15000,19000,4000,4.99,26.67,80,0.99
"4912",4912,"The Reject Demon: Toko Chapter 0 — Prelude",16000,19000,3000,4.99,18.75,90,0.49
"4913",4913,"Pilot Brothers",17000,19000,2000,4.99,11.76,75,1.24
"4914",4914,"Twilight City: Love as a Cure",13000,19000,6000,6.99,46.15,80,1.39
"4915",4915,"Movavi Video Suite 17 - Video Making Software - Video Editor, Video Converter, Screen Capture, and more",1000,19000,18000,79.99,1800,90,7.99
"4916",4916,"Freddi Fish 2: The Case of the Haunted Schoolhouse",17000,19000,2000,6.99,11.76,60,2.79
"4917",4917,"SiNKR",14000,19000,5000,0.99,35.71,25,0.74
"4918",4918,"Pahelika: Secret Legends",15000,19000,4000,1.99,26.67,50,0.99
"4919",4919,"The Happy Hereafter",17000,19000,2000,3.99,11.76,88,0.49
"4920",4920,"Felt Tip Circus",17000,19000,2000,7.99,11.76,85,1.19
"4921",4921,"Lamplight City",0,19000,19000,14.99,0,15,12.74
"4922",4922,"NO THING",12000,19000,7000,3.99,58.33,75,0.99
"4923",4923,"Formata",16000,19000,3000,14.99,18.75,40,8.99
"4924",4924,"YOU DON'T KNOW JACK Vol. 2",1000,19000,18000,2.99,1800,50,1.49
"4925",4925,"Draw Puzzle 画之谜",15000,19000,4000,4.99,26.67,50,2.49
"4926",4926,"LocoCycle",16000,19000,3000,9.99,18.75,75,2.49
"4927",4927,"Zombo Buster Rising",16000,19000,3000,1.99,18.75,50,0.99
"4928",4928,"Call of Cthulhu: Prisoner of Ice",8000,19000,11000,5.99,137.5,75,1.49
"4929",4929,"Almightree: The Last Dreamer",13000,19000,6000,4.99,46.15,90,0.49
"4930",4930,"Ski-World Simulator",16000,19000,3000,9.99,18.75,70,2.99
"4931",4931,"Son of Nor",13000,19000,6000,19.99,46.15,75,4.99
"4932",4932,"Piggy Princess",13000,19000,6000,3.99,46.15,75,0.99
"4933",4933,"Solstice Chronicles: MIA",14000,19000,5000,19.99,35.71,50,9.99
"4934",4934,"1931: Scheherazade at the Library of Pergamum",12000,19000,7000,14.99,58.33,75,3.74
"4935",4935,"Ground Control Anthology",9000,19000,10000,4.99,111.11,66,1.69
"4936",4936,"La-Mulana 2",0,19000,19000,24.99,0,20,19.99
"4937",4937,"Western 1849 Reloaded",17000,19000,2000,4.99,11.76,80,0.99
"4938",4938,"Redneck Rampage",3000,19000,16000,9.99,533.33,66,3.39
"4939",4939,"MotoGP17",15000,19000,4000,39.99,26.67,75,9.99
"4940",4940,"Space Beast Terror Fright",15000,19000,4000,14.99,26.67,41,8.84
"4941",4941,"爱上火车-Pure Station- Maitetsu:Pure Station",0,19000,19000,24.99,0,43,14.24
"4942",4942,"Bitardia",11000,19000,8000,4.99,72.73,70,1.49
"4943",4943,"Selenophobia",15000,19000,4000,1.99,26.67,60,0.79
"4944",4944,"The Adventures of Kusoge",9000,19000,10000,0.99,111.11,51,0.49
"4945",4945,"Downward",17000,19000,2000,9.99,11.76,50,4.99
"4946",4946,"Die Young",13000,19000,6000,14.99,46.15,30,10.49
"4947",4947,"Civil War II",17000,19000,2000,39.99,11.76,65,13.99
"4948",4948,"Paradigm",13000,19000,6000,14.99,46.15,33,10.04
"4949",4949,"Legend of Kay Anniversary",14000,19000,5000,19.99,35.71,75,4.99
"4950",4950,"Story of a Cube",14000,19000,5000,5.99,35.71,0,5.99
"4951",4951,"LoveKami -Divinity Stage-",13000,19000,6000,12.99,46.15,60,5.19
"4952",4952,"Math RTS",10000,19000,9000,4.99,90,0,4.99
"4953",4953,"Voxel Turf",11000,19000,8000,7.99,72.73,38,4.95
"4954",4954,"Starting The Game",4000,19000,15000,0.99,375,51,0.49
"4955",4955,"Spellbind : Luppe's tale",12000,19000,7000,2.99,58.33,0,2.99
"4956",4956,"O! STRELALKA!!!",14000,19000,5000,0.99,35.71,51,0.49
"4957",4957,"99Vidas",11000,19000,8000,12.99,72.73,75,3.24
"4958",4958,"神舞幻想 Faith of Danschant",10000,19000,9000,29.99,90,0,29.99
"4959",4959,"The Cabin: VR Escape the Room",10000,19000,9000,4.99,90,55,2.24
"4960",4960,"Hylics",15000,19000,4000,2.99,26.67,50,1.49
"4961",4961,"Run or Die",14000,19000,5000,4.99,35.71,90,0.49
"4962",4962,"Caravanserail",17000,19000,2000,2.99,11.76,75,0.74
"4963",4963,"LA Cops",11000,19000,8000,14.99,72.73,75,3.74
"4964",4964,"Majestic Nights",17000,19000,2000,4.99,11.76,0,4.99
"4965",4965,"Hypership Out of Control",17000,19000,2000,1.99,11.76,50,0.99
"4966",4966,"Sunset",14000,19000,5000,19.99,35.71,50,9.99
"4967",4967,"Wildlife Park 2 - Horses",16000,19000,3000,3.99,18.75,33,2.67
"4968",4968,"Soundboxing",17000,19000,2000,7.99,11.76,50,3.99
"4969",4969,"Pembrey",7000,19000,12000,0.99,171.43,84,0.49
"4970",4970,"Code of Princess",16000,19000,3000,14.99,18.75,60,5.99
"4971",4971,"Caramba!",0,19000,19000,0.99,0,40,0.59
"4972",4972,"The Fidelio Incident",11000,19000,8000,9.99,72.73,90,0.99
"4973",4973,"Tennis Elbow 2013",17000,19000,2000,24.99,11.76,45,13.74
"4974",4974,"The Uninvited: MacVenture Series",9000,19000,10000,2.99,111.11,0,2.99
"4975",4975,"Polygon Attack",16000,19000,3000,0.99,18.75,51,0.49
"4976",4976,"Epic Manager - Create Your Own Adventuring Agency!",14000,19000,5000,17.99,35.71,75,4.49
"4977",4977,"Freaky Awesome",9000,19000,10000,9.99,111.11,75,2.49
"4978",4978,"Access Denied",12000,19000,7000,2.99,58.33,70,0.89
"4979",4979,"Caveman Craig",14000,19000,5000,4.99,35.71,0,4.99
"4980",4980,"Club Life",14000,19000,5000,11.99,35.71,50,4.99
"4981",4981,"New York Mysteries: Secrets of the Mafia",15000,19000,4000,6.99,26.67,65,2.44
"4982",4982,"My Coloring Book: Food and Beverage",2000,19000,17000,0.99,850,51,0.49
"4983",4983,"Ironclads: Schleswig War 1864",14000,19000,5000,9.99,35.71,90,0.99
"4984",4984,"Nitroplus Blasterz: Heroines Infinite Duel",17000,19000,2000,29.99,11.76,70,8.99
"4985",4985,"Kama Bullet Heritage",13000,19000,6000,0.99,46.15,51,0.49
"4986",4986,"Giant Machines 2017",15000,19000,4000,19.99,26.67,80,3.99
"4987",4987,"Weed Shop 2",16000,19000,3000,9.99,18.75,50,4.99
"4988",4988,"Mini World: Block Art",14000,19000,5000,1.99,35.71,10,1.79
"4989",4989,"Cornerstone: The Song of Tyrim",11000,19000,8000,19.99,72.73,75,4.99
"4990",4990,"Disney•Pixar Cars",10000,19000,9000,19.99,90,65,6.99
"4991",4991,"Share",11000,19000,8000,0.99,72.73,51,0.49
"4992",4992,"Bastard Bonds",17000,19000,2000,12.99,11.76,60,6.39
"4993",4993,"Hero Generations",13000,19000,6000,5.99,46.15,85,0.89
"4994",4994,"Where's My What?",14000,19000,5000,0.99,35.71,80,0.49
"4995",4995,"Earthworm Jim 3D",17000,19000,2000,19.99,11.76,66,6.79
"4996",4996,"Malebolgia",13000,19000,6000,12.99,46.15,90,1.29
"4997",4997,"West of Red",8000,19000,11000,4.99,137.5,90,0.49
"4998",4998,"Iggy's Egg Adventure",17000,19000,2000,4.99,11.76,80,0.99
"4999",4999,"PAC-MAN MUSEUM",15000,19000,4000,19.99,26.67,75,4.99
"5000",5000,"Cats are Liquid - A Light in the Shadows",17000,19000,2000,0.99,11.76,35,0.64
"5001",5001,"Freedom March: Rebel Leader",14000,19000,5000,3.99,35.71,75,1.24
"5002",5002,"Super Trench Attack 2",15000,19000,4000,4.99,26.67,90,0.49
"5003",5003,"Johnny Graves—The Unchosen One",16000,19000,3000,4.99,18.75,90,0.49
"5004",5004,"Helium",11000,19000,8000,4.99,72.73,80,0.99
"5005",5005,"The Archetype",14000,19000,5000,1.99,35.71,0,1.99
"5006",5006,"Change",7000,19000,12000,4.99,171.43,50,2.49
"5007",5007,"Chuck's Challenge 3D",17000,19000,2000,3.99,11.76,75,0.99
"5008",5008,"Dude Simulator",10000,19000,9000,4.99,90,90,0.49
"5009",5009,"MUSYNX",0,19000,19000,3.99,0,10,3.59
"5010",5010,"The Infectious Madness of Doctor Dekker",11000,19000,8000,8.99,72.73,40,5.39
"5011",5011,"Jane Angel: Templar Mystery",17000,19000,2000,4.99,11.76,80,0.99
"5012",5012,"Captain Lycop : Invasion of the Heters",14000,19000,5000,0.99,35.71,0,0.99
"5013",5013,"The Golf Club VR",13000,19000,6000,19.99,46.15,50,14.99
"5014",5014,"Junk Jack",15000,19000,4000,14.99,26.67,25,11.24
"5015",5015,"Lost Lands: The Four Horsemen",17000,19000,2000,6.99,11.76,65,2.44
"5016",5016,"WIN THE GAME: WTF!",2000,18000,16000,0.99,800,51,0.49
"5017",5017,"Bunker - The Underground Game",9000,18000,9000,3.99,100,80,0.79
"5018",5018,"Nameless ~The one thing you must recall~",12000,18000,6000,29.99,50,25,22.49
"5019",5019,"Beat The Dictators",14000,18000,4000,4.99,28.57,0,4.99
"5020",5020,"Killer Backflip 5",2000,18000,16000,0.99,800,51,0.49
"5021",5021,"Alpha Polaris : A Horror Adventure Game",8000,18000,10000,9.99,125,85,1.49
"5022",5022,"Apocalipsis",4000,18000,14000,6.99,350,40,4.19
"5023",5023,"GamersGoMakers",16000,18000,2000,9.99,12.5,50,4.99
"5024",5024,"LOGistICAL",6000,18000,12000,9.99,200,50,4.99
"5025",5025,"Tokyo Hosto",13000,18000,5000,4.99,38.46,0,4.99
"5026",5026,"Othello",12000,18000,6000,9.99,50,75,2.49
"5027",5027,"Aerannis",16000,18000,2000,4.99,12.5,90,0.49
"5028",5028,"Akuatica",2000,18000,16000,4.99,800,60,2.79
"5029",5029,"Gunship!",13000,18000,5000,6.99,38.46,75,1.74
"5030",5030,"Lost Technology",12000,18000,6000,4.99,50,30,3.49
"5031",5031,"Doodle Mafia",14000,18000,4000,7.99,28.57,71,2.31
"5032",5032,"12 orbits",16000,18000,2000,1.99,12.5,25,1.49
"5033",5033,"Russian AYE Race",5000,18000,13000,0.99,260,51,0.49
"5034",5034,"Black & White Bushido",16000,18000,2000,12.99,12.5,75,3.24
"5035",5035,"Crystalline",10000,18000,8000,19.99,80,33,13.39
"5036",5036,"Karate Master 2 Knock Down Blow",16000,18000,2000,9.99,12.5,50,4.99
"5037",5037,"Trickster VR: Co-op Dungeon Crawler",15000,18000,3000,12.99,20,50,6.49
"5038",5038,"Children of Zodiarcs",16000,18000,2000,17.99,12.5,50,8.99
"5039",5039,"Dice Tower Defense",11000,18000,7000,0.99,63.64,51,0.49
"5040",5040,"The Treasures of Montezuma 3",15000,18000,3000,3.99,20,88,0.49
"5041",5041,"Fields XY",13000,18000,5000,3.99,38.46,80,0.79
"5042",5042,"E.T. Armies",15000,18000,3000,14.99,20,90,1.49
"5043",5043,"Tavernier",16000,18000,2000,2.99,12.5,67,0.98
"5044",5044,"Gloom",12000,18000,6000,9.99,50,85,1.49
"5045",5045,"Ultimate Spider Hero",3000,18000,15000,1.99,500,75,0.49
"5046",5046,"Backgammon Blitz",7000,18000,11000,3.99,157.14,70,1.19
"5047",5047,"BOLSOMITO",0,18000,18000,4.99,0,10,4.49
"5048",5048,"Touhou Genso Wanderer -Reloaded- / 不可思议的幻想乡TOD -RELOADED- / 不思議の幻想郷TOD -RELOADED-",0,18000,18000,34.99,0,20,27.99
"5049",5049,"Bomb Squad Academy",7000,18000,11000,4.99,157.14,50,2.49
"5050",5050,"Onechanbara Z2: Chaos",16000,18000,2000,39.99,12.5,50,19.99
"5051",5051,"The Letter - Horror Visual Novel",13000,18000,5000,19.99,38.46,40,11.99
"5052",5052,"TurnOn",16000,18000,2000,14.99,12.5,90,1.49
"5053",5053,"Farmington Tales",15000,18000,3000,4.99,20,80,0.99
"5054",5054,"The Metronomicon: Slay The Dance Floor",16000,18000,2000,19.99,12.5,75,4.99
"5055",5055,"Tangledeep",13000,18000,5000,14.99,38.46,33,10.04
"5056",5056,"Black Closet",11000,18000,7000,19.99,63.64,70,5.99
"5057",5057,"Forestry 2017 - The Simulation",14000,18000,4000,19.99,28.57,75,4.99
"5058",5058,"Rencounter",14000,18000,4000,5.99,28.57,90,0.59
"5059",5059,"Rogue Wizards",15000,18000,3000,14.99,20,0,14.99
"5060",5060,"A Wolf in Autumn",13000,18000,5000,1.99,38.46,60,0.79
"5061",5061,"Fabula Mortis",12000,18000,6000,7.99,50,90,0.79
"5062",5062,"Eador. Imperium",13000,18000,5000,19.99,38.46,80,3.99
"5063",5063,"Hakuoki: Kyoto Winds / 薄桜鬼 真改　風ノ章 / 薄櫻鬼 真改　風之章",7000,18000,11000,29.99,157.14,85,4.49
"5064",5064,"WARPZONE DRIFTER",0,18000,18000,1.99,0,50,0.99
"5065",5065,"Farm Mechanic Simulator 2015",16000,18000,2000,9.99,12.5,66,3.39
"5066",5066,"Deadly Sin",14000,18000,4000,4.99,28.57,80,0.99
"5067",5067,"Pesadelo - Regressão",14000,18000,4000,5.99,28.57,80,1.19
"5068",5068,"Bus Driver Simulator 2019",9000,18000,9000,9.99,100,25,7.49
"5069",5069,"Joint Operations: Combined Arms Gold",16000,18000,2000,19.99,12.5,80,4.99
"5070",5070,"Last Days of Spring 2",6000,18000,12000,6.99,200,66,2.37
"5071",5071,"SENRAN KAGURA Bon Appétit! - Full Course",14000,18000,4000,29.99,28.57,70,8.99
"5072",5072,"Tahira: Echoes of the Astral Empire",4000,18000,14000,14.99,350,50,7.49
"5073",5073,"Disney Universe",16000,18000,2000,19.99,12.5,65,6.99
"5074",5074,"Pro Rugby Manager 2015",15000,18000,3000,9.99,20,90,0.99
"5075",5075,"A Robot Named Fight!",8000,18000,10000,12.99,125,50,6.49
"5076",5076,"Field of Glory II",14000,18000,4000,29.99,28.57,51,14.69
"5077",5077,"Block Legend DX",6000,18000,12000,4.99,200,75,1.24
"5078",5078,"Cinemaware Anthology: 1986-1991",16000,18000,2000,9.99,12.5,75,2.49
"5079",5079,"ANTIFECTOR",0,18000,18000,2.99,0,0,2.99
"5080",5080,"TT Isle of Man",12000,18000,6000,39.99,50,60,15.99
"5081",5081,"Home Improvisation: Furniture Sandbox",13000,18000,5000,9.99,38.46,50,4.99
"5082",5082,"Arcane Sorcery",16000,18000,2000,4.99,12.5,85,0.74
"5083",5083,"Wild Animal Racing",11000,18000,7000,3.99,63.64,33,2.67
"5084",5084,"Deep Sky Derelicts",7000,18000,11000,19.99,157.14,25,12.79
"5085",5085,"Maximum Override",16000,18000,2000,6.99,12.5,75,1.74
"5086",5086,"Highlands",16000,18000,2000,4.99,12.5,65,1.74
"5087",5087,"Apothecarium: The Renaissance of Evil - Premium Edition",16000,18000,2000,6.99,12.5,75,1.74
"5088",5088,"Beauty Bounce",13000,18000,5000,5.99,38.46,60,2.19
"5089",5089,"Fear the Dead",3000,18000,15000,0.99,500,40,0.59
"5090",5090,"18+",0,18000,18000,0.99,0,51,0.49
"5091",5091,"Big Thinkers Kindergarten",12000,18000,6000,6.99,50,72,1.95
"5092",5092,"Never give up!",12000,18000,6000,2.99,50,50,1.49
"5093",5093,"MOTHERGUNSHIP",0,18000,18000,24.99,0,40,14.99
"5094",5094,"Quadrant M4",11000,18000,7000,0.99,63.64,51,0.49
"5095",5095,"Prehistoric Tales",13000,18000,5000,2.99,38.46,70,0.89
"5096",5096,"Sister’s Secrecy: Arcanum Bloodlines - Premium Edition",16000,18000,2000,6.99,12.5,75,1.74
"5097",5097,"SnakEscape",15000,18000,3000,7.99,20,90,0.79
"5098",5098,"Reagan Gorbachev",2000,18000,16000,9.99,800,75,2.49
"5099",5099,"Big Thinkers 1st Grade",12000,18000,6000,6.99,50,72,1.95
"5100",5100,"Olav: the story of one boy",1000,18000,17000,2.99,1700,83,0.5
"5101",5101,"Ironclads: Chincha Islands War 1866",14000,18000,4000,9.99,28.57,90,0.99
"5102",5102,"Beeftacular",9000,18000,9000,2.99,100,72,0.83
"5103",5103,"EggK47",6000,18000,12000,0.99,200,51,0.49
"5104",5104,"Digital Resistance",0,18000,18000,0.99,0,51,0.49
"5105",5105,"The Crypts of Anak Shaba - VR",8000,18000,10000,0.99,125,51,0.49
"5106",5106,"Mold on Pizza",15000,18000,3000,5.99,20,50,2.99
"5107",5107,"Villagers",16000,18000,2000,19.99,12.5,75,4.99
"5108",5108,"Identity",0,18000,18000,29.99,0,10,26.99
"5109",5109,"Perfection.",16000,18000,2000,2.99,12.5,83,0.5
"5110",5110,"Summer Funland",2000,18000,16000,19.99,800,33,13.39
"5111",5111,"Alteric",11000,18000,7000,3.99,63.64,75,0.99
"5112",5112,"Pajama Sam's Lost & Found",8000,18000,10000,4.99,125,80,0.99
"5113",5113,"Army Men RTS",11000,18000,7000,5.99,63.64,50,2.99
"5114",5114,"Tavern Tycoon - Dragon's Hangover",14000,18000,4000,10.99,28.57,40,6.59
"5115",5115,"TOXIC PLUMBING",6000,18000,12000,4.99,200,90,0.5
"5116",5116,"FIVE: Champions of Canaan",12000,17000,5000,3.99,41.67,75,0.99
"5117",5117,"Mad Dagger 2",4000,17000,13000,0.99,325,51,0.49
"5118",5118,"Carcassonne - Tiles & Tactics",5000,17000,12000,9.99,240,60,3.99
"5119",5119,"Coming Out on Top",13000,17000,4000,14.99,30.77,34,9.89
"5120",5120,"CALENDULA",7000,17000,10000,6.99,142.86,80,1.39
"5121",5121,"Shadowcrypt",9000,17000,8000,4.99,88.89,80,0.99
"5122",5122,"Vortex: The Gateway",15000,17000,2000,7.99,13.33,60,3.19
"5123",5123,"The Girl on the Train",14000,17000,3000,0.99,21.43,45,0.54
"5124",5124,"Shipwreck",9000,17000,8000,2.99,88.89,75,0.74
"5125",5125,"Dude Simulator 2",0,17000,17000,4.99,0,90,0.49
"5126",5126,"The Franz Kafka Videogame",11000,17000,6000,6.99,54.55,72,1.95
"5127",5127,"Solitairica",6000,17000,11000,9.99,183.33,75,2.49
"5128",5128,"Null Vector",12000,17000,5000,4.99,41.67,30,3.49
"5129",5129,"World of Tea",4000,17000,13000,0.99,325,51,0.49
"5130",5130,"JYDGE",14000,17000,3000,14.99,21.43,70,4.49
"5131",5131,"Dream Chamber",15000,17000,2000,9.99,13.33,70,2.99
"5132",5132,"OmniBus",15000,17000,2000,9.99,13.33,75,2.49
"5133",5133,"Hero and Daughter+",8000,17000,9000,9.99,112.5,60,3.99
"5134",5134,"Heroes Rise: HeroFall",12000,17000,5000,3.99,41.67,25,2.99
"5135",5135,"Sudoku Quest",12000,17000,5000,5.99,41.67,35,3.89
"5136",5136,"Battle for Enlor",3000,17000,14000,3.99,466.67,50,1.99
"5137",5137,"HUBE: Seeker of Achievements",2000,17000,15000,0.99,750,51,0.49
"5138",5138,"Blade & Bones",10000,17000,7000,10.99,70,90,1.09
"5139",5139,"Super Seducer 2",0,17000,17000,12.99,0,31,8.96
"5140",5140,"Run Rabbit Run",15000,17000,2000,3.99,13.33,50,1.99
"5141",5141,"Protoshift",15000,17000,2000,0.99,13.33,51,0.49
"5142",5142,"Legends of Atlantis: Exodus",15000,17000,2000,6.99,13.33,85,1.04
"5143",5143,"VR Baseball",15000,17000,2000,8.98,13.33,0,8.98
"5144",5144,"Delta Force: Xtreme",13000,17000,4000,19.99,30.77,80,4.99
"5145",5145,"Polaris Sector",12000,17000,5000,39.99,41.67,75,9.99
"5146",5146,"MOAI: Build Your Dream",13000,17000,4000,6.99,30.77,90,0.69
"5147",5147,"Ghost Files: The Face of Guilt",10000,17000,7000,9.99,70,60,3.99
"5148",5148,"Legends of Ellaria",13000,17000,4000,16.99,30.77,30,11.89
"5149",5149,"Crimson Gray",12000,17000,5000,9.99,41.67,50,4.99
"5150",5150,"Lawnmower Game 2: Drifter",9000,17000,8000,0.99,88.89,51,0.49
"5151",5151,"Nicole",15000,17000,2000,18.99,13.33,75,4.74
"5152",5152,"Evo Explores",15000,17000,2000,3.99,13.33,51,1.95
"5153",5153,"GAIN",12000,17000,5000,4.99,41.67,0,4.99
"5154",5154,"5089: The Action RPG",14000,17000,3000,7.99,21.43,35,5.19
"5155",5155,"Time Rifters",15000,17000,2000,9.99,13.33,60,3.99
"5156",5156,"Strange Night",9000,17000,8000,3.99,88.89,50,1.99
"5157",5157,"One Final Breath",10000,17000,7000,3.99,70,87,0.51
"5158",5158,"SCALPERS: Turtle & the Moonshine Gang",5000,17000,12000,9.99,240,50,4.99
"5159",5159,"Burning Cars",14000,17000,3000,5.99,21.43,70,1.79
"5160",5160,"Roots of Insanity",14000,17000,3000,6.99,21.43,90,0.69
"5161",5161,"Lumini",12000,17000,5000,12.99,41.67,80,2.59
"5162",5162,"Troubleshooter",10000,17000,7000,19.99,70,25,14.99
"5163",5163,"The Eyes of Ara",11000,17000,6000,14.99,54.55,60,5.99
"5164",5164,"Dark Years",12000,17000,5000,14.99,41.67,90,1.49
"5165",5165,"IronWolf VR",15000,17000,2000,19.99,13.33,25,14.99
"5166",5166,"Crystal Story II",15000,17000,2000,2.99,13.33,67,0.98
"5167",5167,"AOK Adventures Of Kok",11000,17000,6000,0.99,54.55,51,0.49
"5168",5168,"Danmaku Unlimited 3",5000,17000,12000,9.99,240,80,1.99
"5169",5169,"Harmonia",12000,17000,5000,9.99,41.67,70,2.99
"5170",5170,"The Bard's Tale Trilogy",0,17000,17000,14.99,0,0,14.99
"5171",5171,"Dude, Stop",12000,17000,5000,14.99,41.67,40,8.99
"5172",5172,"Navalny 20!8 : The Rise of Evil",8000,17000,9000,1.99,112.5,75,0.49
"5173",5173,"Masked Forces: Zombie Survival",13000,17000,4000,0.99,30.77,51,0.49
"5174",5174,"Mr. Triangle's Adventure",15000,17000,2000,0.99,13.33,25,0.74
"5175",5175,"Slap The Fly",14000,17000,3000,5.99,21.43,0,5.99
"5176",5176,"Cubic",12000,17000,5000,0.99,41.67,87,0.49
"5177",5177,"Driving School Simulator",13000,17000,4000,14.99,30.77,75,3.74
"5178",5178,"Deathtrap Dungeon",12000,17000,5000,6.99,41.67,86,0.97
"5179",5179,"MoonDigger",2000,17000,15000,0.99,750,51,0.49
"5180",5180,"Alekhine's Gun",7000,17000,10000,39.99,142.86,75,9.99
"5181",5181,"Reflection of Mine",15000,17000,2000,7.99,13.33,75,1.99
"5182",5182,"Lionessy Story",11000,17000,6000,4.99,54.55,90,0.49
"5183",5183,"Kisaragi no Hougyoku",6000,17000,11000,3.99,183.33,0,3.99
"5184",5184,"Lingering Fragrance",0,17000,17000,3.99,0,30,2.79
"5185",5185,"Lowpoly Hero",3000,17000,14000,4.99,466.67,0,4.99
"5186",5186,"Call of Bitcoin",2000,17000,15000,0.99,750,51,0.49
"5187",5187,"Let Them Come",10000,17000,7000,4.99,70,60,1.99
"5188",5188,"Mimpi",12000,17000,5000,3.99,41.67,80,0.79
"5189",5189,"Galactic Battles",6000,17000,11000,4.99,183.33,90,0.5
"5190",5190,"Pastelia Stories",12000,17000,5000,9.99,41.67,20,7.99
"5191",5191,"Kalimba",15000,17000,2000,9.99,13.33,75,2.49
"5192",5192,"Trench Run",12000,17000,5000,3.99,41.67,75,0.99
"5193",5193,"Grim Nights",0,17000,17000,2.99,0,0,2.99
"5194",5194,"Apokalypsis",15000,17000,2000,1.99,13.33,75,0.49
"5195",5195,"Loot Hunter",14000,17000,3000,6.99,21.43,75,1.99
"5196",5196,"Midvinter",9000,17000,8000,4.99,88.89,75,1.24
"5197",5197,"Blitz Breaker",11000,17000,6000,0.99,54.55,51,0.49
"5198",5198,"Armada 2526",15000,17000,2000,14.99,13.33,85,2.24
"5199",5199,"Fireworks Simulator",15000,17000,2000,9.99,13.33,60,3.99
"5200",5200,"VERLIES II",12000,17000,5000,4.99,41.67,90,0.49
"5201",5201,"Murder Mystery Adventure",15000,17000,2000,4.99,13.33,80,0.99
"5202",5202,"Lost Grimoires: Stolen Kingdom",8000,17000,9000,9.99,112.5,70,2.99
"5203",5203,"Great Big War Game",8000,17000,9000,6.99,112.5,0,6.99
"5204",5204,"Run!ZombieFood!",15000,17000,2000,3.99,13.33,10,3.59
"5205",5205,"G-Ball",15000,17000,2000,0.99,13.33,0,0.99
"5206",5206,"Battle Fantasia -Revised Edition-",14000,17000,3000,14.99,21.43,80,2.99
"5207",5207,"Chiptune Champion",12000,17000,5000,9.99,41.67,50,4.99
"5208",5208,"Shotgun Raiders",15000,17000,2000,2.99,13.33,0,2.99
"5209",5209,"Wars and Warriors: Joan of Arc",12000,17000,5000,6.99,41.67,75,1.74
"5210",5210,"Lost Grimoires 2: Shard of Mystery",11000,17000,6000,9.99,54.55,70,2.99
"5211",5211,"BuildMoreCubes",3000,17000,14000,1.99,466.67,50,0.99
"5212",5212,"Fabric",8000,17000,9000,9.99,112.5,0,9.99
"5213",5213,"The Last Dream: Developer's Edition",14000,17000,3000,9.99,21.43,78,2.19
"5214",5214,"Check vs Mate",14000,17000,3000,19.99,21.43,85,2.99
"5215",5215,"Charlie Murder",11000,17000,6000,9.99,54.55,50,4.99
"5216",5216,"Commander: The Great War",13000,17000,4000,29.99,30.77,67,9.89
"5217",5217,"Skyflower",15000,17000,2000,2.99,13.33,0,2.99
"5218",5218,"Superfighters Deluxe",0,17000,17000,12.99,0,10,11.69
"5219",5219,"Mass Exodus",13000,17000,4000,14.99,30.77,0,14.99
"5220",5220,"Adventures of Abrix",15000,17000,2000,4.99,13.33,86,0.69
"5221",5221,"Freddi Fish 4: The Case of the Hogfish Rustlers of Briny Gulch",15000,17000,2000,6.99,13.33,60,2.79
"5222",5222,"Shootout on Cash Island",8000,17000,9000,2.99,112.5,80,0.59
"5223",5223,"God of Failure",4000,17000,13000,4.99,325,90,0.49
"5224",5224,"Star Phoenix",6000,17000,11000,9.99,183.33,35,6.49
"5225",5225,"Capitalism 2",9000,17000,8000,9.99,88.89,20,7.99
"5226",5226,"COAST GUARD",13000,17000,4000,14.99,30.77,80,2.99
"5227",5227,"Dark Gates",13000,17000,4000,3.99,30.77,70,1.19
"5228",5228,"RunningDead",14000,16000,2000,1.99,14.29,10,1.79
"5229",5229,"Vzerthos: The Heir of Thunder",6000,16000,10000,6.99,166.67,78,1.53
"5230",5230,"Castaway Paradise - Town Building Sim",11000,16000,5000,14.99,45.45,70,4.49
"5231",5231,"RUN ROOMS",9000,16000,7000,1.99,77.78,75,0.49
"5232",5232,"Black Moon Chronicles",14000,16000,2000,5.99,14.29,50,2.99
"5233",5233,"Her Majesty's SPIFFING",7000,16000,9000,11.99,128.57,70,3.59
"5234",5234,"CAPSULE",14000,16000,2000,4.99,14.29,80,0.99
"5235",5235,"Masky",14000,16000,2000,0.99,14.29,51,0.49
"5236",5236,"Zero Caliber VR",0,16000,16000,24.99,0,10,22.49
"5237",5237,"Cursed Treasure 2",4000,16000,12000,4.99,300,50,2.49
"5238",5238,"The Wanderings Dragon",0,16000,16000,0.99,0,51,0.49
"5239",5239,"猎人物语",11000,16000,5000,3.99,45.45,0,3.99
"5240",5240,"Sydney's World",9000,16000,7000,4.99,77.78,60,1.99
"5241",5241,"On The Road",12000,16000,4000,17.99,33.33,33,12.05
"5242",5242,"Run For Rum",4000,16000,12000,4.99,300,90,0.49
"5243",5243,"Karnage Chronicles",10000,16000,6000,24.99,60,33,16.74
"5244",5244,"SHOCK TROOPERS 2nd Squad",12000,16000,4000,7.99,33.33,50,3.99
"5245",5245,"On My Own",11000,16000,5000,4.99,45.45,0,4.99
"5246",5246,"Double Dragon IV",10000,16000,6000,6.99,60,50,3.49
"5247",5247,"Demetrios - The BIG Cynical Adventure",10000,16000,6000,9.99,60,75,2.49
"5248",5248,"WARRIORS ALL-STARS / 無双☆スターズ",12000,16000,4000,59.99,33.33,50,29.99
"5249",5249,"ЕСТЬ ДВА СТУЛА",0,16000,16000,0.99,0,51,0.49
"5250",5250,"Highborn",14000,16000,2000,1.99,14.29,0,1.99
"5251",5251,"Vaporum",12000,16000,4000,19.99,33.33,50,9.99
"5252",5252,"Ace of Seafood",14000,16000,2000,11.99,14.29,50,5.99
"5253",5253,"Wildlife Park 2 - Farm World",7000,16000,9000,3.99,128.57,33,2.67
"5254",5254,"Undefeated",13000,16000,3000,9.99,23.08,90,0.99
"5255",5255,"A.R.E.S. Extinction Agenda EX",13000,16000,3000,9.99,23.08,80,1.99
"5256",5256,"Rebirth of Island",14000,16000,2000,4.99,14.29,75,1.24
"5257",5257,"Monster Energy Supercross - The Official Videogame",11000,16000,5000,49.99,45.45,70,14.99
"5258",5258,"Breezeblox",12000,16000,4000,2.99,33.33,40,1.79
"5259",5259,"NASWAY",14000,16000,2000,0.99,14.29,51,0.49
"5260",5260,"The Survey",13000,16000,3000,4.99,23.08,80,0.99
"5261",5261,"ZomDay",12000,16000,4000,9.99,33.33,30,6.99
"5262",5262,"Evochron Legacy",13000,16000,3000,24.99,23.08,30,17.49
"5263",5263,"Helicopter 2015: Natural Disasters",14000,16000,2000,9.99,14.29,75,2.49
"5264",5264,"Bohemian Killing",12000,16000,4000,12.99,33.33,70,3.89
"5265",5265,"Invisibox",10000,16000,6000,0.99,60,51,0.49
"5266",5266,"England Exchange",5000,16000,11000,14.99,220,60,5.99
"5267",5267,"Emerge: Cities of the Apocalypse",7000,16000,9000,7.99,128.57,75,1.99
"5268",5268,"3D Ultra Minigolf Adventures",11000,16000,5000,9.99,45.45,75,2.49
"5269",5269,"Descenders",11000,16000,5000,24.99,45.45,15,21.24
"5270",5270,"Shining Resonance Refrain",0,16000,16000,49.99,0,50,24.99
"5271",5271,"Murder",13000,16000,3000,0.99,23.08,51,0.49
"5272",5272,"The House in Fata Morgana",9000,16000,7000,24.99,77.78,50,12.49
"5273",5273,"Sayonara Umihara Kawase",12000,16000,4000,14.99,33.33,50,7.49
"5274",5274,"Starship Corporation",9000,16000,7000,19.99,77.78,50,9.99
"5275",5275,"Baron Wittard: Nemesis of Ragnarok",14000,16000,2000,7.99,14.29,0,7.99
"5276",5276,"Fairly Certain Doom",5000,16000,11000,1.99,220,0,1.99
"5277",5277,"Mutant Football League",13000,16000,3000,19.99,23.08,0,19.99
"5278",5278,"Hentai Shooter 3D",0,16000,16000,0.99,0,51,0.49
"5279",5279,"Arcadecraft",14000,16000,2000,9.99,14.29,0,9.99
"5280",5280,"Sumoman",11000,16000,5000,16.99,45.45,69,5.26
"5281",5281,"Just Ignore Them",12000,16000,4000,3.99,33.33,87,0.51
"5282",5282,"Fitz the Fox",13000,16000,3000,3.99,23.08,0,3.99
"5283",5283,"Kyn",14000,16000,2000,19.99,14.29,90,1.99
"5284",5284,"Lethe - Episode One",12000,16000,4000,14.99,33.33,85,2.24
"5285",5285,"Geo",3000,16000,13000,8.99,433.33,50,4.49
"5286",5286,"Limiter",3000,16000,13000,2.99,433.33,25,2.24
"5287",5287,"Haeven",10000,16000,6000,4.99,60,90,0.49
"5288",5288,"Earth Space Colonies",14000,16000,2000,9.99,14.29,90,0.99
"5289",5289,"Achievement Hunter: Begins",14000,16000,2000,0.99,14.29,51,0.49
"5290",5290,"Chopper: Lethal darkness",14000,16000,2000,2.99,14.29,33,2
"5291",5291,"Space Tyrant",8000,16000,8000,19.99,100,70,5.99
"5292",5292,"samurai_jazz",12000,16000,4000,0.99,33.33,51,0.49
"5293",5293,"Tren0",9000,16000,7000,2.99,77.78,40,1.79
"5294",5294,"Dog Sled Saga",14000,16000,2000,7.99,14.29,50,3.99
"5295",5295,"Elisa: the Innkeeper",9000,16000,7000,4.99,77.78,70,2.49
"5296",5296,"Nimbatus - The Space Drone Constructor",0,16000,16000,19.99,0,20,15.99
"5297",5297,"Stellar Tactics",12000,16000,4000,19.99,33.33,0,19.99
"5298",5298,"Backstage Pass",14000,16000,2000,29.99,14.29,45,16.49
"5299",5299,"Lucky Panda",11000,16000,5000,3.99,45.45,87,0.49
"5300",5300,"Mind Games",13000,16000,3000,2.99,23.08,83,0.5
"5301",5301,"Castle of no Escape",13000,16000,3000,3.99,23.08,88,0.49
"5302",5302,"Vulture for NetHack",12000,16000,4000,2.99,33.33,50,1.49
"5303",5303,"The Colonists",0,16000,16000,24.99,0,10,22.49
"5304",5304,"Nature Treks VR",10000,16000,6000,9.99,60,33,6.69
"5305",5305,"Weird Dungeon Explorer: Wave Beat",4000,16000,12000,0.99,300,51,0.49
"5306",5306,"Pixel Dungeon",11000,16000,5000,4.99,45.45,60,1.99
"5307",5307,"Dodge",12000,16000,4000,1.99,33.33,0,1.99
"5308",5308,"Isoland 2 - Ashes of Time",4000,16000,12000,2.99,300,70,0.89
"5309",5309,"Ys SEVEN",11000,16000,5000,24.99,45.45,40,14.99
"5310",5310,"Warriors & Castles",11000,16000,5000,2.99,45.45,50,1.49
"5311",5311,"STAY",8000,16000,8000,11.99,100,35,7.79
"5312",5312,"We Know the Devil",11000,16000,5000,7.99,45.45,75,1.99
"5313",5313,"aMaze Achievements : forest",8000,16000,8000,0.99,100,51,0.49
"5314",5314,"Chronicles of Teddy",14000,16000,2000,14.99,14.29,60,5.99
"5315",5315,"TY the Tasmanian Tiger 2",13000,16000,3000,14.99,23.08,45,8.24
"5316",5316,"Pixel Zombie",10000,16000,6000,0.99,60,51,0.49
"5317",5317,"Pressure Overdrive",12000,16000,4000,12.99,33.33,50,6.49
"5318",5318,"CMYW",10000,16000,6000,3.99,60,0,3.99
"5319",5319,"Black Ice",12000,16000,4000,14.99,33.33,25,11.24
"5320",5320,"Evertown",12000,16000,4000,2.99,33.33,0,2.99
"5321",5321,"The Slug",12000,16000,4000,3.99,33.33,87,0.49
"5322",5322,"EXIST",6000,16000,10000,0.99,166.67,51,0.49
"5323",5323,"Crayon Chronicles",14000,16000,2000,3.99,14.29,55,1.79
"5324",5324,"Steampunk Tower 2",8000,16000,8000,7.99,100,40,4.79
"5325",5325,"Exodus from the Earth",14000,16000,2000,14.99,14.29,90,1.49
"5326",5326,"Uncraft World",13000,16000,3000,9.99,23.08,60,3.99
"5327",5327,"Nancy Drew: Alibi in Ashes",13000,16000,3000,6.99,23.08,40,4.19
"5328",5328,"Go Kart Survival",7000,16000,9000,0.99,128.57,51,0.49
"5329",5329,"Forget Me Not: My Organic Garden",14000,16000,2000,9.99,14.29,70,2.99
"5330",5330,"CodeSpells",12000,16000,4000,19.99,33.33,50,9.99
"5331",5331,"Seduce Me 2: The Demon War",13000,16000,3000,9.99,23.08,50,4.99
"5332",5332,"AFTERGRINDER",13000,16000,3000,4.99,23.08,80,0.99
"5333",5333,"NeonGalaxy Wars",7000,16000,9000,0.99,128.57,51,0.49
"5334",5334,"The Beggar's Ride",10000,16000,6000,5.99,60,80,1.19
"5335",5335,"Weird Dungeon Explorer: Defender",3000,16000,13000,0.99,433.33,51,0.49
"5336",5336,"Feudalism",6000,16000,10000,14.99,166.67,90,1.49
"5337",5337,"Square's Route",14000,16000,2000,3.99,14.29,87,0.51
"5338",5338,"Mini Knight",7000,16000,9000,0.99,128.57,51,0.49
"5339",5339,"DEAD DOZEN Escape",9000,16000,7000,11.99,77.78,70,3.59
"5340",5340,"Jelly in the sky",5000,16000,11000,5.99,220,90,0.59
"5341",5341,"Auralux: Constellations",4000,16000,12000,9.99,300,80,1.99
"5342",5342,"Cyber Fight",2000,16000,14000,0.99,700,51,0.49
"5343",5343,"CO-OP : Decrypted",9000,16000,7000,9.99,77.78,50,4.99
"5344",5344,"Catch & Release",5000,16000,11000,19.99,220,0,19.99
"5345",5345,"Ninja Reflex: Steamworks Edition",14000,16000,2000,4.99,14.29,0,4.99
"5346",5346,"VR: Vacate the Room",13000,16000,3000,3.99,23.08,42,2.31
"5347",5347,"Veil of Crows",11000,15000,4000,14.99,36.36,30,10.49
"5348",5348,"Nanomedix Inc",3000,15000,12000,0.99,400,0,0.99
"5349",5349,"Trigger Runners",12000,15000,3000,1.99,25,0,1.99
"5350",5350,"Viki Spotter: The Farm",4000,15000,11000,1.99,275,75,0.49
"5351",5351,"Star Trek: Starfleet Academy",11000,15000,4000,9.99,36.36,66,3.39
"5352",5352,"Don't cut your hand",11000,15000,4000,0.99,36.36,30,0.69
"5353",5353,"PeriAreion",13000,15000,2000,5.99,15.38,0,5.99
"5354",5354,"HoD: On open seas",6000,15000,9000,3.99,150,0,3.99
"5355",5355,"Battle Mages",13000,15000,2000,3.99,15.38,88,0.49
"5356",5356,"These nights in Cairo",5000,15000,10000,7.99,200,50,3.99
"5357",5357,"WAR DUST | 32 vs 32 Battles",0,15000,15000,24.99,0,40,14.99
"5358",5358,"Save the Creatures",5000,15000,10000,1.99,200,0,1.99
"5359",5359,"Mirrored - Chapter 1",13000,15000,2000,1.99,15.38,50,0.99
"5360",5360,"The Painscreek Killings",6000,15000,9000,19.99,150,75,4.99
"5361",5361,"Vampire: The Masquerade - Redemption",13000,15000,2000,5.99,15.38,75,1.49
"5362",5362,"Dragon Spear",0,15000,15000,14.99,0,34,9.89
"5363",5363,"Princess Kaguya: Legend of the Moon Warrior",11000,15000,4000,10.99,36.36,70,3.29
"5364",5364,"Angels with Scaly Wings",11000,15000,4000,9.99,36.36,40,5.99
"5365",5365,"Why Am I Dead At Sea",7000,15000,8000,4.99,114.29,60,1.99
"5366",5366,"Thunderbird: The Legend Begins",3000,15000,12000,5.99,400,0,5.99
"5367",5367,"Trio",8000,15000,7000,0.99,87.5,0,0.99
"5368",5368,"Egypt: Old Kingdom",6000,15000,9000,14.99,150,50,7.49
"5369",5369,"Ephemerid: A Musical Adventure",11000,15000,4000,1.99,36.36,0,1.99
"5370",5370,"Bear Simulator",13000,15000,2000,14.99,15.38,0,14.99
"5371",5371,"The Seven Years War (1756-1763)",12000,15000,3000,19.99,25,90,1.99
"5372",5372,"Cave Runner",8000,15000,7000,0.99,87.5,0,0.99
"5373",5373,"One Wish",6000,15000,9000,0.99,150,51,0.49
"5374",5374,"Rememoried",13000,15000,2000,9.99,15.38,90,0.99
"5375",5375,"Star Trek : 25th Anniversary",12000,15000,3000,9.99,25,66,3.39
"5376",5376,"Kumoon : Ballistic Physics Puzzle",9000,15000,6000,2.99,66.67,0,2.99
"5377",5377,"Ninjahtic",9000,15000,6000,1.99,66.67,60,0.79
"5378",5378,"Last Will",8000,15000,7000,8.99,87.5,70,2.69
"5379",5379,"The Consuming Shadow",11000,15000,4000,9.99,36.36,75,2.49
"5380",5380,"Prison Boss VR",13000,15000,2000,19.99,15.38,50,9.99
"5381",5381,"Ultimus bellum",13000,15000,2000,9.99,15.38,33,6.69
"5382",5382,"Twins of the Pasture",12000,15000,3000,7.99,25,0,7.99
"5383",5383,"Firebird - La Peri",12000,15000,3000,3.99,25,50,1.99
"5384",5384,"Rulers of Nations",11000,15000,4000,19.99,36.36,50,9.99
"5385",5385,"旧手表 - Old Watch",8000,15000,7000,9.99,87.5,40,5.99
"5386",5386,"Dead Sea",10000,15000,5000,4.99,50,33,3.34
"5387",5387,"Boot Hill Heroes",7000,15000,8000,8.99,114.29,50,4.49
"5388",5388,"Sexy Jigsaw / Sexy Puzzle / 性感拼图",0,15000,15000,3.99,0,55,1.79
"5389",5389,"Astro Bouncer",0,15000,15000,0.99,0,51,0.49
"5390",5390,"Project Remedium",9000,15000,6000,14.99,66.67,75,3.74
"5391",5391,"Petrichor",11000,15000,4000,1.99,36.36,75,0.49
"5392",5392,"Hide & Hold Out - H2o",13000,15000,2000,17.99,15.38,0,17.99
"5393",5393,"Fatty Bear's Birthday Surprise",11000,15000,4000,6.99,36.36,60,2.79
"5394",5394,"Ruckus Ridge VR Party",4000,15000,11000,9.99,275,0,9.99
"5395",5395,"Candleman: The Complete Journey",10000,15000,5000,14.99,50,50,7.49
"5396",5396,"Safety First!",12000,15000,3000,2.99,25,75,0.74
"5397",5397,"Mad Bullets",13000,15000,2000,2.99,15.38,50,1.49
"5398",5398,"Timespinner",0,15000,15000,19.99,0,10,17.99
"5399",5399,"Omega Strike",5000,15000,10000,12.99,200,65,4.54
"5400",5400,"Vagrant Hearts",11000,15000,4000,9.99,36.36,90,0.99
"5401",5401,"Heart&Slash",13000,15000,2000,14.99,15.38,50,7.49
"5402",5402,"Corpse of Discovery",12000,15000,3000,7.99,25,80,1.59
"5403",5403,"Professor Fizzwizzle and the Molten Mystery",9000,15000,6000,6.99,66.67,60,2.79
"5404",5404,"BossConstructor",13000,15000,2000,14.99,15.38,50,7.49
"5405",5405,"Exoplanet: First Contact",10000,15000,5000,19.99,50,25,14.99
"5406",5406,"Space Warp",11000,15000,4000,4.99,36.36,0,4.99
"5407",5407,"Sunrise: survival",5000,15000,10000,3.99,200,60,1.99
"5408",5408,"Galagan's Island: Reprymian Rising",13000,15000,2000,1.99,15.38,0,1.99
"5409",5409,"Music Band Manager",11000,15000,4000,7.99,36.36,75,1.99
"5410",5410,"ShineG In The Zombies",10000,15000,5000,1.99,50,50,0.99
"5411",5411,"Snooker Nation Championship",11000,15000,4000,3.99,36.36,70,1.19
"5412",5412,"Pixel Space Battles",8000,15000,7000,0.99,87.5,51,0.49
"5413",5413,"Kohan: Ahriman's Gift",13000,15000,2000,9.99,15.38,0,9.99
"5414",5414,"Californium",11000,15000,4000,9.99,36.36,60,3.99
"5415",5415,"Tic-Toc-Tower",10000,15000,5000,2.99,50,84,0.49
"5416",5416,"The Quest",12000,15000,3000,9.99,25,50,4.99
"5417",5417,"Soldier of Failure 2",11000,15000,4000,3.99,36.36,87,0.49
"5418",5418,"Laserlife",10000,15000,5000,9.99,50,90,1.49
"5419",5419,"Infectonator 3: Apocalypse",7000,15000,8000,12.99,114.29,30,9.09
"5420",5420,"Siralim 2",13000,15000,2000,14.99,15.38,80,2.99
"5421",5421,"Chicken Invaders 4",12000,15000,3000,4.99,25,50,2.49
"5422",5422,"Vertigo",13000,15000,2000,14.99,15.38,60,5.99
"5423",5423,"Pike and Shot : Campaigns",10000,15000,5000,39.99,50,75,9.99
"5424",5424,"Creeper World: Anniversary Edition",11000,15000,4000,4.99,36.36,80,0.99
"5425",5425,"Mighty Switch Force! Hyper Drive Edition",13000,15000,2000,9.99,15.38,50,4.99
"5426",5426,"Nancy Drew: Secret of the Scarlet Hand",12000,15000,3000,6.99,25,40,4.19
"5427",5427,"Knockout League - Arcade VR Boxing",11000,15000,4000,29.99,36.36,33,20.09
"5428",5428,"Root Double -Before Crime * After Days- Xtend Edition",10000,15000,5000,34.99,50,65,12.24
"5429",5429,"Mystery Chronicle: One Way Heroics",12000,15000,3000,9.99,25,90,0.99
"5430",5430,"Cowboy Escape",9000,15000,6000,0.99,66.67,30,0.69
"5431",5431,"The Princess' Heart",13000,15000,2000,4.99,15.38,80,0.99
"5432",5432,"Gunman Clive 2",12000,15000,3000,2.99,25,0,2.99
"5433",5433,"Glow",9000,15000,6000,4.99,66.67,60,1.99
"5434",5434,"Skylar & Plux: Adventure On Clover Island",9000,15000,6000,14.99,66.67,70,4.49
"5435",5435,"Age of Barbarian Extended Cut",9000,15000,6000,12.99,66.67,40,7.79
"5436",5436,"The Thing: Space X",11000,15000,4000,0.99,36.36,51,0.49
"5437",5437,"Battle Girls",5000,15000,10000,11.99,200,35,5.19
"5438",5438,"Coffin of Ashes",11000,15000,4000,6.99,36.36,30,4.89
"5439",5439,"Ravenmark: Scourge of Estellion",13000,15000,2000,14.99,15.38,75,3.74
"5440",5440,"Tiny Bubbles",2000,15000,13000,9.99,650,20,7.99
"5441",5441,"ARCADE GAME SERIES: Ms. PAC-MAN",11000,15000,4000,3.99,36.36,50,1.99
"5442",5442,"Groove Coaster",0,15000,15000,19.99,0,20,15.99
"5443",5443,"planetarian HD",13000,15000,2000,9.99,15.38,50,4.99
"5444",5444,"Ilamentia",11000,15000,4000,2.99,36.36,35,2.54
"5445",5445,"The Myth Seekers: The Legacy of Vulcan",10000,15000,5000,9.99,50,60,3.99
"5446",5446,"Ninja Tycoon",8000,15000,7000,4.99,87.5,40,2.99
"5447",5447,"300 Dwarves",9000,15000,6000,6.99,66.67,50,3.49
"5448",5448,"Oil Enterprise",10000,15000,5000,19.99,50,70,5.99
"5449",5449,"Blowy Fish",13000,15000,2000,1.99,15.38,75,0.49
"5450",5450,"Second Warfare",12000,15000,3000,14.99,25,90,1.49
"5451",5451,"YOU DON'T KNOW JACK Vol. 4 The Ride",4000,15000,11000,2.99,275,50,1.49
"5452",5452,"Overkill VR: Action Shooter FPS",13000,15000,2000,19.99,15.38,50,9.99
"5453",5453,"Sandmason",13000,15000,2000,3.99,15.38,75,0.99
"5454",5454,"The Battle for Sector 219",10000,15000,5000,6.99,50,90,0.69
"5455",5455,"Tales of the Lumminai",6000,15000,9000,6.99,150,50,3.49
"5456",5456,"Dark Angels: Masquerade of Shadows",12000,15000,3000,3.99,25,80,0.79
"5457",5457,"The Land of Pain",7000,15000,8000,9.99,114.29,85,1.49
"5458",5458,"Idle Evolution",6000,15000,9000,4.99,150,75,1.24
"5459",5459,"Vostok Inc.",9000,15000,6000,14.99,66.67,50,7.49
"5460",5460,"Yasai Ninja",12000,15000,3000,1.99,25,60,0.79
"5461",5461,"Metal Fatigue",0,15000,15000,5.99,0,50,2.99
"5462",5462,"Run, Run, Monsters!",0,15000,15000,0.99,0,51,0.49
"5463",5463,"Pivot Pilot",12000,15000,3000,6.99,25,80,1.39
"5464",5464,"Football Club Simulator - FCS NS#19",12000,15000,3000,9.95,25,70,2.98
"5465",5465,"Fake/SuperSonia",13000,15000,2000,0.99,15.38,45,0.54
"5466",5466,"Zup! Zero 2",0,15000,15000,0.99,0,30,0.69
"5467",5467,"World War II GI",9000,15000,6000,6.99,66.67,75,1.74
"5468",5468,"Super GunWorld 2",1000,14000,13000,7.99,1300,0,7.99
"5469",5469,"Brigade E5: New Jagged Union",12000,14000,2000,3.99,16.67,77,0.91
"5470",5470,"StarsOne",12000,14000,2000,9.99,16.67,75,2.49
"5471",5471,"Christmas Adventure: Candy Storm",11000,14000,3000,1.99,27.27,50,0.99
"5472",5472,"Rescue Lucy",11000,14000,3000,2.99,27.27,83,0.5
"5473",5473,"ChromaGun",9000,14000,5000,12.99,55.56,50,6.49
"5474",5474,"天使帝國四《Empire of Angels IV》",11000,14000,3000,14.99,27.27,50,7.49
"5475",5475,"Achron",12000,14000,2000,19.99,16.67,0,19.99
"5476",5476,"The Free Ones",0,14000,14000,9.99,0,70,4.49
"5477",5477,"Freedom Cry",8000,14000,6000,6.99,75,90,0.69
"5478",5478,"Evil Bank Manager",0,14000,14000,11.99,0,10,10.79
"5479",5479,"Animal Super Squad",10000,14000,4000,9.99,40,60,3.99
"5480",5480,"Disney's Treasure Planet: Battle of Procyon",10000,14000,4000,9.99,40,70,2.99
"5481",5481,"Smart Mummy",9000,14000,5000,3.99,55.56,87,0.49
"5482",5482,"Warp Rider",8000,14000,6000,0.99,75,51,0.49
"5483",5483,"Hogs of War",10000,14000,4000,4.99,40,50,2.49
"5484",5484,"Sparc",8000,14000,6000,19.99,75,50,9.99
"5485",5485,"One Hour One Life",0,14000,14000,19.99,0,0,19.99
"5486",5486,"Inner Chains",8000,14000,6000,19.99,75,80,3.99
"5487",5487,"Afterlife Empire",7000,14000,7000,4.99,100,0,4.99
"5488",5488,"The Adventures of Fatman",10000,14000,4000,1.99,40,74,0.51
"5489",5489,"Cubotrox",12000,14000,2000,5.99,16.67,0,5.99
"5490",5490,"Shining Plume",12000,14000,2000,3.99,16.67,87,0.51
"5491",5491,"Songbringer",10000,14000,4000,19.99,40,50,9.99
"5492",5492,"Fighting Fantasy Legends",4000,14000,10000,9.99,250,60,3.99
"5493",5493,"Night Vigil",11000,14000,3000,4.99,27.27,50,2.49
"5494",5494,"The Miskatonic",0,14000,14000,5.99,0,33,4.01
"5495",5495,"The Memory of Eldurim",10000,14000,4000,0.99,40,0,0.99
"5496",5496,"Pocket God vs Desert Ashes",8000,14000,6000,4.99,75,0,4.99
"5497",5497,"Tale of Fallen Dragons",8000,14000,6000,9.99,75,75,2.49
"5498",5498,"StarShip Constructor",8000,14000,6000,4.99,75,35,3.24
"5499",5499,"Xenus 2. White gold.",11000,14000,3000,14.99,27.27,60,5.99
"5500",5500,"Midnight's Blessing",7000,14000,7000,9.99,100,90,0.99
"5501",5501,"Kingspray Graffiti VR",11000,14000,3000,14.99,27.27,50,7.49
"5502",5502,"McDROID",12000,14000,2000,9.99,16.67,75,2.49
"5503",5503,"Scary House",1000,14000,13000,4.99,1300,75,1.24
"5504",5504,"The Witch's Yarn",9000,14000,5000,9.99,55.56,90,0.99
"5505",5505,"Sabbat of the Witch",0,14000,14000,29.99,0,10,26.99
"5506",5506,"Pilot Brothers 2",8000,14000,6000,4.99,75,75,1.24
"5507",5507,"Maria the Witch",12000,14000,2000,4.99,16.67,80,0.99
"5508",5508,"Acorn Assault: Rodent Revolution",9000,14000,5000,9.99,55.56,90,0.99
"5509",5509,"LEAVES - The Journey",9000,14000,5000,7.99,55.56,80,1.59
"5510",5510,"武林志（Wushu Chronicles）",0,14000,14000,12.99,0,20,10.39
"5511",5511,"Ghoulboy - Dark Sword of Goblin",9000,14000,5000,3.99,55.56,50,1.99
"5512",5512,"Epic Showdown",10000,14000,4000,4.99,40,0,4.99
"5513",5513,"Dark Quest",12000,14000,2000,2.99,16.67,50,1.49
"5514",5514,"Funk of Titans",12000,14000,2000,6.99,16.67,90,0.69
"5515",5515,"Shotgun Farmers",11000,14000,3000,9.99,27.27,50,4.99
"5516",5516,"Impossible Quest",9000,14000,5000,1.99,55.56,75,0.49
"5517",5517,"LA soul",10000,14000,4000,0.99,40,51,0.49
"5518",5518,"War Birds: WW2 Air strike 1942",11000,14000,3000,3.99,27.27,0,3.99
"5519",5519,"Wrestling Spirit 3",9000,14000,5000,19.99,55.56,75,4.99
"5520",5520,"Guards",9000,14000,5000,4.99,55.56,80,0.99
"5521",5521,"The Under",7000,14000,7000,1.99,100,75,0.49
"5522",5522,"Trap Them",10000,14000,4000,4.99,40,80,0.99
"5523",5523,"Hive Jump",10000,14000,4000,19.99,40,80,3.99
"5524",5524,"Outcast - Second Contact",11000,14000,3000,34.99,27.27,70,10.49
"5525",5525,"Butsbal",12000,14000,2000,2.99,16.67,75,0.74
"5526",5526,"Small Town Terrors: Livingston",7000,14000,7000,9.99,100,75,2.49
"5527",5527,"Revolution Under Siege Gold",10000,14000,4000,24.99,40,75,6.24
"5528",5528,"ClusterPuck 99",10000,14000,4000,9.99,40,0,9.99
"5529",5529,"Brain Spa",11000,14000,3000,9.99,27.27,66,3.39
"5530",5530,"Musclecar Online",8000,14000,6000,5.99,75,75,1.49
"5531",5531,"DashBored",12000,14000,2000,4.99,16.67,75,1.24
"5532",5532,"Play With Kizami",0,14000,14000,2.99,0,40,1.79
"5533",5533,"Stick Man Fight 3",0,14000,14000,0.99,0,51,0.49
"5534",5534,"GhostControl Inc.",12000,14000,2000,14.99,16.67,60,5.99
"5535",5535,"Tadpole Treble",12000,14000,2000,4.99,16.67,60,1.99
"5536",5536,"Frost",3000,14000,11000,6.99,366.67,30,4.89
"5537",5537,"Hyper Box",12000,14000,2000,2.99,16.67,0,2.99
"5538",5538,"Nurse Love Addiction",11000,14000,3000,39.99,27.27,55,17.99
"5539",5539,"Faces of Illusion: The Twin Phantoms",11000,14000,3000,9.99,27.27,70,2.99
"5540",5540,"Project: Gorgon",10000,14000,4000,39.99,40,25,29.99
"5541",5541,"Little Big Adventure - Enhanced Edition",12000,14000,2000,5.99,16.67,50,2.99
"5542",5542,"FLYVALNY 20!8",8000,14000,6000,0.99,75,45,0.54
"5543",5543,"Talewind",5000,14000,9000,8.99,180,85,1.34
"5544",5544,"Everything is Peachy",6000,14000,8000,3.99,133.33,75,0.99
"5545",5545,"Space Rogue",12000,14000,2000,9.99,16.67,77,2.29
"5546",5546,"PAC-MAN and the Ghostly Adventures",12000,14000,2000,19.99,16.67,75,4.99
"5547",5547,"Sally's Law",12000,14000,2000,3.99,16.67,70,1.19
"5548",5548,"Atomik: RunGunJumpGun",12000,14000,2000,7.99,16.67,90,0.79
"5549",5549,"Faerie Solitaire Remastered",9000,14000,5000,9.99,55.56,0,9.99
"5550",5550,"Joy Pony",10000,14000,4000,0.99,40,51,0.49
"5551",5551,"To Be or Not To Be",11000,14000,3000,4.99,27.27,60,1.99
"5552",5552,"Escape The Past",9000,14000,5000,4.99,55.56,75,1.24
"5553",5553,"iZBOT",11000,14000,3000,11.99,27.27,90,1.19
"5554",5554,"WarBirds - World War II Combat Aviation - 2018",6000,14000,8000,14.99,133.33,50,7.49
"5555",5555,"Leona's Tricky Adventures",10000,14000,4000,9.99,40,80,1.99
"5556",5556,"A Goo Adventure",11000,14000,3000,1.99,27.27,69,0.61
"5557",5557,"GravNewton",9000,14000,5000,0.99,55.56,90,0.49
"5558",5558,"1979 Invasion Earth",9000,14000,5000,1.99,55.56,0,1.99
"5559",5559,"The Legend of Protey",0,14000,14000,0.99,0,10,0.89
"5560",5560,"Phantom Signal — Sci-Fi Strategy Game",10000,14000,4000,5.99,40,49,1.99
"5561",5561,"Chef Solitaire: USA",12000,14000,2000,2.99,16.67,50,1.49
"5562",5562,"Quell Memento",10000,14000,4000,3.99,40,88,0.49
"5563",5563,"MX vs ATV All Out",8000,14000,6000,39.99,75,50,19.99
"5564",5564,"Masterspace",12000,14000,2000,7.99,16.67,75,1.99
"5565",5565,"Puzzle Tactics",5000,14000,9000,0.99,180,51,0.49
"5566",5566,"Achievement Clicker",9000,14000,5000,0.99,55.56,51,0.49
"5567",5567,"Carp Fishing Simulator",11000,14000,3000,12.99,27.27,0,12.99
"5568",5568,"Aegis",9000,14000,5000,2.99,55.56,69,0.92
"5569",5569,"Computer Tycoon",12000,14000,2000,14.99,16.67,35,9.74
"5570",5570,"Formula Fusion",9000,14000,5000,19.99,55.56,0,19.99
"5571",5571,"HandyCopter",2000,14000,12000,4.99,600,70,2.39
"5572",5572,"Stardust Galaxy Warriors: Stellar Climax",11000,14000,3000,9.99,27.27,70,2.99
"5573",5573,"The Tale of a Common Man",4000,14000,10000,9.99,250,90,0.99
"5574",5574,"Major\Minor",12000,14000,2000,19.99,16.67,90,1.99
"5575",5575,"LUXIS",10000,14000,4000,4.99,40,83,0.84
"5576",5576,"TAL: Arctic",0,14000,14000,0.99,0,51,0.49
"5577",5577,"Sacrament",6000,14000,8000,1.99,133.33,60,0.79
"5578",5578,"Locked Fears",9000,14000,5000,0.99,55.56,0,0.99
"5579",5579,"新流星搜劍錄",9000,14000,5000,19.99,55.56,60,7.99
"5580",5580,"Incognito",9000,14000,5000,7.99,55.56,90,0.79
"5581",5581,"Sky Knights",6000,14000,8000,9.99,133.33,40,5.99
"5582",5582,"Achievement Idler: Black",3000,14000,11000,0.99,366.67,0,0.99
"5583",5583,"The Search",4000,14000,10000,3.99,250,75,0.99
"5584",5584,"Antagonist",12000,14000,2000,2.99,16.67,70,0.89
"5585",5585,"Rex Nebular and the Cosmic Gender Bender",12000,14000,2000,6.99,16.67,75,1.74
"5586",5586,"The Esoterica: Hollow Earth",10000,14000,4000,3.99,40,75,0.99
"5587",5587,"Space Robot Samurai Zombie Slayer",6000,14000,8000,1.99,133.33,50,0.99
"5588",5588,"Air Missions: HIND",11000,14000,3000,16.99,27.27,60,6.79
"5589",5589,"Save the Furries",9000,14000,5000,6.99,55.56,58,2.93
"5590",5590,"Construction Simulator 2 US - Pocket Edition",0,14000,14000,11.99,0,10,10.79
"5591",5591,"Toonstruck",11000,14000,3000,9.99,27.27,66,3.39
"5592",5592,"Wave of Darkness",12000,14000,2000,29.99,16.67,70,8.99
"5593",5593,"Don't Chat With Strangers",5000,14000,9000,4.99,180,80,0.99
"5594",5594,"Street Arena",12000,14000,2000,6.99,16.67,90,0.69
"5595",5595,"Blade and Sorcery",0,14000,14000,19.99,0,0,19.99
"5596",5596,"Magi Trials",11000,14000,3000,11.99,27.27,40,5.39
"5597",5597,"Putt-Putt and Pep's Balloon-o-Rama",9000,14000,5000,4.99,55.56,60,1.99
"5598",5598,"Sky Gamblers: Storm Raiders",11000,14000,3000,9.99,27.27,66,3.39
"5599",5599,"Sigi - A Fart for Melusina",6000,14000,8000,2.99,133.33,50,1.49
"5600",5600,"LEGO DC Super-Villains",0,14000,14000,39.99,0,50,19.99
"5601",5601,"150,000 B.C.",11000,14000,3000,0.99,27.27,51,0.49
"5602",5602,"Polterheist",9000,14000,5000,4.99,55.56,90,0.49
"5603",5603,"akda",4000,14000,10000,0.99,250,51,0.49
"5604",5604,"Hyper Simon X",0,14000,14000,0.99,0,51,0.49
"5605",5605,"Virtual Rides 3 - Funfair Simulator",5000,14000,9000,24.99,180,50,12.49
"5606",5606,"Disney•Pixar Toy Story Mania!",11000,14000,3000,19.99,27.27,70,5.99
"5607",5607,"Super Meat Shooter",8000,13000,5000,5.99,62.5,90,0.59
"5608",5608,"Nancy Drew: The Shattered Medallion",9000,13000,4000,19.99,44.44,40,11.99
"5609",5609,"Freddi Fish and Luther's Water Worries",6000,13000,7000,4.99,116.67,60,1.99
"5610",5610,"Signal Ops",11000,13000,2000,9.99,18.18,85,1.49
"5611",5611,"The Gallery - Episode 2: Heart of the Emberstone",10000,13000,3000,29.99,30,50,14.99
"5612",5612,"80's style",0,13000,13000,1.99,0,75,0.49
"5613",5613,"Castle Chaos",9000,13000,4000,7.99,44.44,66,2.71
"5614",5614,"Music Wars Empire",8000,13000,5000,14.99,62.5,30,10.49
"5615",5615,"LEGO The Incredibles",6000,13000,7000,39.99,116.67,50,19.99
"5616",5616,"Weapon of Choice",9000,13000,4000,4.99,44.44,80,0.99
"5617",5617,"Firefighters - The Simulation",10000,13000,3000,14.99,30,66,5.09
"5618",5618,"Danger Zone",4000,13000,9000,14.99,225,60,5.99
"5619",5619,"Lords of the Realm",2000,13000,11000,1.99,550,66,0.67
"5620",5620,"Drift Tuner 2019",3000,13000,10000,1.99,333.33,50,1.99
"5621",5621,"Triple Otakus Puzzle",9000,13000,4000,0.99,44.44,51,0.49
"5622",5622,"Elisa: Seduce the Innkeeper",8000,13000,5000,4.99,62.5,67,2.49
"5623",5623,"Freddi Fish and Luther's Maze Madness",2000,13000,11000,4.99,550,60,1.99
"5624",5624,"New Ice York",0,13000,13000,9.99,0,40,5.99
"5625",5625,"VRZ: Torment",11000,13000,2000,9.99,18.18,60,3.99
"5626",5626,"Silent Footsteps",0,13000,13000,11.99,0,0,11.99
"5627",5627,"N.E.R.O.: Nothing Ever Remains Obscure",7000,13000,6000,14.99,85.71,90,1.49
"5628",5628,"Battle of the Bulge",11000,13000,2000,9.99,18.18,51,4.89
"5629",5629,"Bottle",11000,13000,2000,1.99,18.18,50,0.99
"5630",5630,"The Deep Paths: Labyrinth Of Andokost",9000,13000,4000,5.99,44.44,50,2.99
"5631",5631,"Masked Shooters",8000,13000,5000,0.99,62.5,51,0.49
"5632",5632,"Ground Breakers",8000,13000,5000,0.99,62.5,50,0.99
"5633",5633,"Happy Santa",10000,13000,3000,3.99,30,87,0.49
"5634",5634,"Heroes of Loot",10000,13000,3000,4.99,30,80,0.99
"5635",5635,"Nancy Drew: The Captive Curse",11000,13000,2000,6.99,18.18,65,2.44
"5636",5636,"Ranger of the jungle",8000,13000,5000,3.99,62.5,70,1.19
"5637",5637,"Soccer Rage",11000,13000,2000,9.99,18.18,0,9.99
"5638",5638,"Gravity puzzles",6000,13000,7000,0.99,116.67,51,0.49
"5639",5639,"Swords and Sandals 2 Redux",6000,13000,7000,6.99,116.67,50,3.49
"5640",5640,"Bezier",8000,13000,5000,9.99,62.5,50,4.99
"5641",5641,"Grav Grav Gravity",8000,13000,5000,0.99,62.5,51,0.49
"5642",5642,"The Slaughter: Act One",11000,13000,2000,6.99,18.18,75,1.74
"5643",5643,"Distant Space 2",9000,13000,4000,0.99,44.44,51,0.49
"5644",5644,"Jet Island",0,13000,13000,19.99,0,10,17.99
"5645",5645,"Zombie Grinder",11000,13000,2000,8.99,18.18,0,8.99
"5646",5646,"Princess Remedy 2: In A Heap of Trouble",11000,13000,2000,4.99,18.18,83,0.5
"5647",5647,"Let's Sing",6000,13000,7000,14.99,116.67,50,7.49
"5648",5648,"Grav Blazer",7000,13000,6000,0.99,85.71,51,0.49
"5649",5649,"Eternal Destiny",9000,13000,4000,9.99,44.44,70,2.99
"5650",5650,"Mystery Castle: The Mirror's Secret",10000,13000,3000,6.99,30,80,1.39
"5651",5651,"Mega Man X Legacy Collection 2 / ロックマンX アニバーサリー コレクション 2",0,13000,13000,19.99,0,25,14.99
"5652",5652,"Mechs & Mercs: Black Talons",8000,13000,5000,9.99,62.5,90,0.99
"5653",5653,"NAL Is Alive",10000,13000,3000,9.99,30,90,0.99
"5654",5654,"Singularity Roller",10000,13000,3000,4.99,30,70,1.49
"5655",5655,"Ninjahtic Mind Tricks",8000,13000,5000,1.99,62.5,60,0.79
"5656",5656,"Vox Machinae",0,13000,13000,24.99,0,0,24.99
"5657",5657,"The Book of Desires",11000,13000,2000,6.99,18.18,80,1.39
"5658",5658,"Delete",5000,13000,8000,1.99,160,30,1.39
"5659",5659,"Autobahn Police Simulator 2",8000,13000,5000,19.99,62.5,50,13.39
"5660",5660,"Battle Simulator",0,13000,13000,0.99,0,51,0.49
"5661",5661,"Dots",7000,13000,6000,1.99,85.71,75,0.49
"5662",5662,"MinosMaze - The Minotaur's Labyrinth",11000,13000,2000,4.99,18.18,90,0.49
"5663",5663,"Don't Knock Twice",9000,13000,4000,19.99,44.44,50,9.99
"5664",5664,"Oh My Gore!",11000,13000,2000,1.99,18.18,75,0.49
"5665",5665,"Scythe: Digital Edition",2000,13000,11000,19.99,550,20,15.99
"5666",5666,"OVIVO",7000,13000,6000,4.99,85.71,80,1.59
"5667",5667,"Zero-G VR",6000,13000,7000,4.99,116.67,80,0.99
"5668",5668,"Akane",0,13000,13000,4.99,0,25,2.99
"5669",5669,"Alphabear: Hardcover Edition",6000,13000,7000,9.99,116.67,60,3.99
"5670",5670,"Arctic Cave",8000,13000,5000,0.99,62.5,51,0.49
"5671",5671,"Ceres",8000,13000,5000,19.99,62.5,85,2.99
"5672",5672,"PAKO - Car Chase Simulator",9000,13000,4000,4.99,44.44,80,0.99
"5673",5673,"Memory Oblivion Box",8000,13000,5000,9.99,62.5,25,7.49
"5674",5674,"Bloody Mice",7000,13000,6000,0.99,85.71,51,0.49
"5675",5675,"Drifting Lands",11000,13000,2000,18.99,18.18,50,9.49
"5676",5676,"ABRACA - Imagic Games",8000,13000,5000,14.99,62.5,70,4.49
"5677",5677,"Fracture the Flag",10000,13000,3000,4.99,30,0,4.99
"5678",5678,"Zombeer",7000,13000,6000,4.99,85.71,0,4.99
"5679",5679,"The Secret Order 5: The Buried Kingdom",9000,13000,4000,9.99,44.44,60,3.99
"5680",5680,"The Amber Throne",11000,13000,2000,14.99,18.18,50,7.49
"5681",5681,"Q.U.B.E. 2",7000,13000,6000,24.99,85.71,50,12.49
"5682",5682,"Achievement Hunter: Golem",10000,13000,3000,0.99,30,51,0.49
"5683",5683,"Star Hammer: The Vanguard Prophecy",10000,13000,3000,19.99,30,75,4.99
"5684",5684,"Dead But Alive! Southern England",9000,13000,4000,14.99,44.44,60,5.99
"5685",5685,"Yoku's Island Express",4000,13000,9000,19.99,225,50,9.99
"5686",5686,"H-Hour: World's Elite",11000,13000,2000,9.99,18.18,66,3.39
"5687",5687,"Psychocat: The Answer",11000,13000,2000,0.99,18.18,30,0.69
"5688",5688,"MadOut Open City",6000,13000,7000,7.99,116.67,60,3.19
"5689",5689,"Children of Colossus",2000,13000,11000,4.99,550,80,0.99
"5690",5690,"Survival: Last Day",5000,13000,8000,3.99,160,35,2.09
"5691",5691,"Koihime Enbu 恋姫†演武",10000,13000,3000,4.99,30,75,4.49
"5692",5692,"Disney Infinity 1.0: Gold Edition",10000,13000,3000,29.99,30,65,10.49
"5693",5693,"The Emptiness Deluxe Edition",11000,13000,2000,9.99,18.18,75,2.49
"5694",5694,"Heart of Crown PC",9000,13000,4000,24.99,44.44,40,14.99
"5695",5695,"True Fear: Forsaken Souls",8000,13000,5000,8.99,62.5,75,2.24
"5696",5696,"One Deck Dungeon",8000,13000,5000,9.99,62.5,30,6.99
"5697",5697,"Awareness Rooms",5000,13000,8000,4.99,160,60,1.99
"5698",5698,"Trackmania² Lagoon",10000,13000,3000,19.99,30,70,5.99
"5699",5699,"Hidden & Dangerous 2: Courage Under Fire",6000,13000,7000,9.99,116.67,67,3.29
"5700",5700,"Trivia Vault: Mini Mixed Trivia",8000,13000,5000,0.99,62.5,51,0.49
"5701",5701,"Syndrome",5000,13000,8000,19.99,160,70,5.99
"5702",5702,"OBEY",11000,13000,2000,14.99,18.18,34,9.89
"5703",5703,"Sphinx and the Cursed Mummy",5000,13000,8000,14.99,160,67,4.94
"5704",5704,"SQUIDS FROM SPACE",10000,13000,3000,2.99,30,90,0.99
"5705",5705,"Neon Shadow",9000,13000,4000,4.99,44.44,50,2.49
"5706",5706,"Royal Bounty HD",11000,13000,2000,2.99,18.18,0,2.99
"5707",5707,"Bowslinger",5000,13000,8000,4.99,160,50,2.49
"5708",5708,"Heaven's Hope - Special Edition",10000,13000,3000,9.99,30,75,2.49
"5709",5709,"Movie Studio Boss: The Sequel",11000,13000,2000,9.99,18.18,90,0.99
"5710",5710,"Caligo",7000,13000,6000,5.99,85.71,90,0.59
"5711",5711,"The Mooseman",8000,13000,5000,6.99,62.5,70,2.09
"5712",5712,"DERE EVIL .EXE",0,13000,13000,0.99,0,45,0.54
"5713",5713,"Flywrench",6000,13000,7000,6.99,116.67,90,0.69
"5714",5714,"Alien Robot Monsters",3000,13000,10000,5.99,333.33,50,2.99
"5715",5715,"The Putinland: Divide & Conquer",0,13000,13000,1.99,0,75,0.49
"5716",5716,"Trivia Vault: Mini Mixed Trivia 4",9000,13000,4000,0.99,44.44,51,0.49
"5717",5717,"Pharaoh Rebirth+",11000,13000,2000,9.99,18.18,70,2.99
"5718",5718,"Harvest Life",4000,13000,9000,14.99,225,60,5.99
"5719",5719,"KOEWOTAYORINI SP / 声之寄托SP",7000,13000,6000,1.99,85.71,60,0.79
"5720",5720,"Outpost Zero",0,13000,13000,19.99,0,30,13.99
"5721",5721,"Franchise Hockey Manager 3",9000,13000,4000,19.99,44.44,0,19.99
"5722",5722,"TREBUCHET",10000,13000,3000,5.99,30,90,0.59
"5723",5723,"Don't Disturb",8000,13000,5000,3.49,62.5,75,0.87
"5724",5724,"Executive Assault 2",0,13000,13000,24.99,0,0,24.99
"5725",5725,"The Scarecrow",4000,13000,9000,0.99,225,51,0.49
"5726",5726,"Megadimension Neptunia VIIR | 新次元ゲイム ネプテューヌＶⅡＲ | 新次元遊戲 戰機少女ＶⅡＲ",0,13000,13000,39.99,0,25,29.99
"5727",5727,"It Lurks Below",9000,13000,4000,19.99,44.44,20,15.99
"5728",5728,"Bad Sector HDD",3000,13000,10000,0.99,333.33,51,0.49
"5729",5729,"Civil Warfare: Another Bullet In The War",8000,13000,5000,0.99,62.5,0,0.99
"5730",5730,"Funfair Ride Simulator 3",7000,13000,6000,5.99,85.71,70,1.79
"5731",5731,"Trapper's Delight",9000,13000,4000,9.99,44.44,66,3.39
"5732",5732,"Dungeons Are Random",11000,13000,2000,1.99,18.18,0,1.99
"5733",5733,"Bleed 2",8000,13000,5000,9.99,62.5,50,4.99
"5734",5734,"Pixel Galaxy",9000,13000,4000,9.99,44.44,90,0.99
"5735",5735,"Crimson Defense",5000,13000,8000,0.99,160,51,0.49
"5736",5736,"New York Mysteries: High Voltage",9000,13000,4000,6.99,44.44,65,2.44
"5737",5737,"GROUND BRANCH",0,13000,13000,19.99,0,20,15.99
"5738",5738,"Dubstep Abasralsa",3000,13000,10000,0.99,333.33,51,0.49
"5739",5739,"Trivia Vault: Mini Mixed Trivia 3",8000,13000,5000,0.99,62.5,51,0.49
"5740",5740,"12 Labours of Hercules VI: Race for Olympus (Platinum Edition)",11000,13000,2000,2.99,18.18,83,0.5
"5741",5741,"When Our Journey Ends - A Visual Novel",11000,13000,2000,6.99,18.18,50,3.49
"5742",5742,"Magic and Challenge RPG",11000,13000,2000,0.99,18.18,51,0.49
"5743",5743,"Dandy: Or a Brief Glimpse Into the Life of the Candy Alchemist",9000,13000,4000,9.99,44.44,0,9.99
"5744",5744,"Heroes of Normandie",10000,13000,3000,29.99,30,67,9.89
"5745",5745,"Gun Wings",11000,13000,2000,3.99,18.18,50,1.99
"5746",5746,"鸿源战纪 - Tales of Hongyuan",10000,13000,3000,14.99,30,20,11.99
"5747",5747,"King of Bali",10000,13000,3000,1.99,30,0,1.99
"5748",5748,"Quest Hunter",10000,13000,3000,14.99,30,35,9.74
"5749",5749,"Pictopix",11000,13000,2000,6.99,18.18,30,4.89
"5750",5750,"Freedom Defender",10000,13000,3000,4.99,30,90,0.49
"5751",5751,"Take Off - The Flight Simulator",6000,13000,7000,6.99,116.67,25,5.24
"5752",5752,"Trivia Vault: Mini Mixed Trivia 2",7000,13000,6000,0.99,85.71,51,0.49
"5753",5753,"XORPLE",5000,13000,8000,0.99,160,51,0.49
"5754",5754,"Invasion of Barbarians",11000,13000,2000,3.99,18.18,85,0.59
"5755",5755,"Shtriga: Summer Camp",10000,13000,3000,3.99,30,75,0.99
"5756",5756,"Tiny Tales: Heart of the Forest",8000,13000,5000,9.99,62.5,50,4.99
"5757",5757,"Pigmentone",5000,13000,8000,1.99,160,75,0.49
"5758",5758,"Spirit Run - Fire vs. Ice",9000,13000,4000,1.99,44.44,75,0.49
"5759",5759,"R-Type Dimensions EX",0,13000,13000,14.99,0,20,11.99
"5760",5760,"Containment Initiative",2000,13000,11000,9.99,550,60,3.99
"5761",5761,"Terra Nova: Strike Force Centauri",5000,13000,8000,5.99,160,80,1.19
"5762",5762,"ROGALIK",1000,13000,12000,0.99,1200,51,0.49
"5763",5763,"LONE WOLF: Horizon",9000,13000,4000,9.99,44.44,90,0.99
"5764",5764,"Global Outbreak: Doomsday Edition",10000,13000,3000,8.99,30,75,2.24
"5765",5765,"Horizon Chase Turbo",6000,13000,7000,19.99,116.67,30,13.99
"5766",5766,"Ion Maiden",7000,13000,6000,19.99,85.71,10,17.99
"5767",5767,"AntVentor",2000,13000,11000,4.99,550,80,0.99
"5768",5768,"Hero-U: Rogue to Redemption",0,13000,13000,34.99,0,50,17.49
"5769",5769,"AirMech Wastelands",3000,13000,10000,19.99,333.33,70,5.99
"5770",5770,"DinoSystem",7000,13000,6000,7.99,85.71,75,1.99
"5771",5771,"Grav Blazer Squared",5000,12000,7000,0.99,140,51,0.49
"5772",5772,"Hero Barrier",10000,12000,2000,3.99,20,50,1.99
"5773",5773,"Contract",7000,12000,5000,2.99,71.43,66,1.01
"5774",5774,"ManaCollect",8000,12000,4000,6.99,50,75,1.74
"5775",5775,"Trivia Vault: Science & History Trivia 2",7000,12000,5000,0.99,71.43,51,0.49
"5776",5776,"Travildorn",6000,12000,6000,5.99,100,90,0.59
"5777",5777,"Shoot 1UP",8000,12000,4000,3.99,50,75,0.99
"5778",5778,"Hexologic",1000,12000,11000,2.99,1100,50,1.49
"5779",5779,"Monsters' Den: Godfall",8000,12000,4000,14.99,50,50,7.49
"5780",5780,"Satellite Rush",8000,12000,4000,4.99,50,50,2.49
"5781",5781,"One Late Night: Deadline",9000,12000,3000,7.99,33.33,85,1.19
"5782",5782,"Flix and Chill 2: Millennials",9000,12000,3000,0.99,33.33,51,0.49
"5783",5783,"Security Hole",8000,12000,4000,9.99,50,66,3.39
"5784",5784,"Dream Car Builder",9000,12000,3000,14.99,33.33,30,10.49
"5785",5785,"Last Dream: World Unknown",10000,12000,2000,9.99,20,80,1.99
"5786",5786,"Forgotton Anne",5000,12000,7000,19.99,140,30,13.99
"5787",5787,"Terroir",10000,12000,2000,14.99,20,70,4.49
"5788",5788,"Dead or School",0,12000,12000,14.99,0,20,11.99
"5789",5789,"Wizrogue - Labyrinth of Wizardry",8000,12000,4000,11.99,50,90,1.19
"5790",5790,"Mushroom Men: Truffle Trouble",9000,12000,3000,2.99,33.33,0,2.99
"5791",5791,"Trivia Vault: 1980's Trivia 2",7000,12000,5000,0.99,71.43,51,0.49
"5792",5792,"Sovereignty: Crown of Kings",9000,12000,3000,24.99,33.33,75,6.24
"5793",5793,"Haven Moon",9000,12000,3000,9.99,33.33,75,2.49
"5794",5794,"Seeking Dawn",0,12000,12000,39.99,0,40,23.99
"5795",5795,"Unfortunate Spacemen",5000,12000,7000,14.99,140,25,11.24
"5796",5796,"Gleaner Heights",7000,12000,5000,9.99,71.43,20,7.99
"5797",5797,"I am not a Monster",0,12000,12000,12.99,0,35,8.44
"5798",5798,"The Shadowland",8000,12000,4000,0.99,50,51,0.49
"5799",5799,"The Great Fusion",8000,12000,4000,2.99,50,75,0.74
"5800",5800,"Odyssey - The Story of Science",10000,12000,2000,14.99,20,70,4.49
"5801",5801,"Assault on Arnhem",2000,12000,10000,9.99,500,50,4.99
"5802",5802,"Blackwood Crossing",5000,12000,7000,15.99,140,60,6.39
"5803",5803,"Where's My Mommy?",9000,12000,3000,5.99,33.33,80,1.19
"5804",5804,"Red Crucible 2: Reborn",0,12000,12000,19.99,0,15,16.99
"5805",5805,"But to Paint a Universe",10000,12000,2000,4.99,20,75,1.24
"5806",5806,"New York Mysteries: The Lantern of Souls",7000,12000,5000,6.99,71.43,65,2.44
"5807",5807,"The Occupant",9000,12000,3000,1.99,33.33,0,1.99
"5808",5808,"Bombing Bastards",5000,12000,7000,9.99,140,75,2.49
"5809",5809,"Dark Days",10000,12000,2000,2.99,20,50,1.49
"5810",5810,"Escape from pyramid",3000,12000,9000,0.99,300,51,0.49
"5811",5811,"VAULT OF HONOR",3000,12000,9000,4.99,300,90,0.49
"5812",5812,"Dungeons Of Kremlin: Remastered",6000,12000,6000,3.99,100,87,0.51
"5813",5813,"The Space Garden",9000,12000,3000,4.99,33.33,0,4.99
"5814",5814,"Contagion VR: Outbreak",0,12000,12000,19.99,0,25,14.99
"5815",5815,"Moonchild",10000,12000,2000,9.99,20,90,0.99
"5816",5816,"Illusoria",4000,12000,8000,9.99,200,55,4.49
"5817",5817,"ALONE IN SPACE",5000,12000,7000,9.99,140,50,4.99
"5818",5818,"Dungeon Crawlers HD",9000,12000,3000,4.99,33.33,0,4.99
"5819",5819,"John Wick Chronicles",10000,12000,2000,19.99,20,0,19.99
"5820",5820,"The Trail: Frontier Challenge",5000,12000,7000,14.99,140,50,7.49
"5821",5821,"Aim Trainer Pro",7000,12000,5000,3.99,71.43,33,2.67
"5822",5822,"PhysDrive",8000,12000,4000,0.99,50,51,0.49
"5823",5823,"Remyadry",0,12000,12000,9.99,0,20,7.99
"5824",5824,"Scalak",4000,12000,8000,1.99,200,20,1.59
"5825",5825,"Trivia Vault: Classic Rock Trivia",9000,12000,3000,0.99,33.33,51,0.49
"5826",5826,"Kitty Run",0,12000,12000,0.99,0,51,0.49
"5827",5827,"Freezeer",0,12000,12000,0.99,0,51,0.49
"5828",5828,"BLADESTORM: Nightmare",10000,12000,2000,59.99,20,70,17.99
"5829",5829,"Plush",8000,12000,4000,3.99,50,85,0.59
"5830",5830,"Fibrillation HD",9000,12000,3000,3.99,33.33,50,1.99
"5831",5831,"Pachansky Mathematics 2+2=8",0,12000,12000,0.99,0,51,0.49
"5832",5832,"Metamorphabet",10000,12000,2000,4.99,20,60,1.99
"5833",5833,"AFFECTED: The Manor",5000,12000,7000,7.99,140,50,3.99
"5834",5834,"Eagle Flight",10000,12000,2000,19.99,20,75,9.99
"5835",5835,"Princess Maker 3: Fairy Tales Come True",10000,12000,2000,19.99,20,45,10.99
"5836",5836,"Visual Novel Maker",8000,12000,4000,59.99,50,30,41.99
"5837",5837,"Under Leaves",4000,12000,8000,4.99,200,70,1.49
"5838",5838,"Scapeland",10000,12000,2000,3.99,20,87,0.51
"5839",5839,"Noel The Mortal Fate S1-7",2000,12000,10000,14.99,500,20,11.99
"5840",5840,"Milkmaid of the Milky Way",5000,12000,7000,5.99,140,60,2.39
"5841",5841,"Curse of the Crescent Isle DX",10000,12000,2000,0.99,20,69,0.74
"5842",5842,"Space Salvager",9000,12000,3000,7.99,33.33,50,3.99
"5843",5843,"Lightrise",8000,12000,4000,0.99,50,0,0.99
"5844",5844,"Warbanners",9000,12000,3000,19.99,33.33,50,9.99
"5845",5845,"BATTLE PIXEL'S SURVIVAL GROUND",9000,12000,3000,0.99,33.33,51,0.49
"5846",5846,"Hakoniwa Explorer Plus",4000,12000,8000,9.99,200,25,7.49
"5847",5847,"Purrfect Date - Visual Novel/Dating Simulator",4000,12000,8000,9.99,200,60,3.99
"5848",5848,"Moorhuhn Invasion (Crazy Chicken Invasion)",8000,12000,4000,3.99,50,75,0.99
"5849",5849,"Trivia Vault: Super Heroes Trivia 2",6000,12000,6000,0.99,100,51,0.49
"5850",5850,"Game Type",7000,12000,5000,2.99,71.43,66,1.01
"5851",5851,"Queen's Quest 2: Stories of Forgotten Past",8000,12000,4000,9.99,50,60,3.99
"5852",5852,"The Wizards",8000,12000,4000,19.99,50,60,8
"5853",5853,"Gunsmith",7000,12000,5000,19.99,71.43,25,14.99
"5854",5854,"Foosball: World Tour",10000,12000,2000,8.99,20,75,2.24
"5855",5855,"Impossible Geometry",8000,12000,4000,1.99,50,0,1.99
"5856",5856,"Cellar",10000,12000,2000,0.99,20,51,0.49
"5857",5857,"TITANS: Dawn of Tribes",9000,12000,3000,9.99,33.33,50,4.99
"5858",5858,"Lovely Planet Arcade",7000,12000,5000,5.99,71.43,50,2.99
"5859",5859,"Dangerous Relationship",3000,12000,9000,15.99,300,80,3.19
"5860",5860,"REPTILOIDS",7000,12000,5000,4.99,71.43,83,0.84
"5861",5861,"Runaway Express Mystery",10000,12000,2000,6.99,20,70,2.09
"5862",5862,"Ladykiller in a Bind",7000,12000,5000,19.99,71.43,75,4.99
"5863",5863,"Fossil Echo",9000,12000,3000,9.99,33.33,75,2.49
"5864",5864,"The Hidden Dragon",10000,12000,2000,2.99,20,80,0.59
"5865",5865,"Terra Mystica",4000,12000,8000,14.99,200,50,7.49
"5866",5866,"Eternal Step",9000,12000,3000,9.99,33.33,90,0.99
"5867",5867,"Star Story: The Horizon Escape",10000,12000,2000,14.99,20,60,5.99
"5868",5868,"Bad birthday",10000,12000,2000,4.99,20,33,3.34
"5869",5869,"Outbreak",10000,12000,2000,9.99,20,90,0.99
"5870",5870,"Winds Of Trade",9000,12000,3000,11.99,33.33,70,3.59
"5871",5871,"Rising Islands",8000,12000,4000,9.99,50,90,0.99
"5872",5872,"Infect and Destroy",10000,12000,2000,6.99,20,0,6.99
"5873",5873,"Xanadu Next",9000,12000,3000,19.99,33.33,60,7.99
"5874",5874,"PIXEL DRIFT",7000,12000,5000,0.99,71.43,30,0.69
"5875",5875,"Echoes of Aetheria",9000,12000,3000,14.99,33.33,75,3.74
"5876",5876,"Vietcong",2000,12000,10000,4.99,500,83,0.84
"5877",5877,"Weird Hero",7000,12000,5000,3.99,71.43,75,0.74
"5878",5878,"BLEAK: Welcome to Glimmer",6000,12000,6000,7.99,100,0,7.99
"5879",5879,"Panzer Strategy",1000,12000,11000,29.99,1100,30,19.99
"5880",5880,"Fermi's Path",10000,12000,2000,8.99,20,70,2.69
"5881",5881,"OneScreen Solar Sails",4000,12000,8000,1.99,200,0,1.99
"5882",5882,"Umihara Kawase",9000,12000,3000,9.99,33.33,50,4.99
"5883",5883,"ERTX 2080TI Mining clicker",0,12000,12000,0.99,0,51,0.49
"5884",5884,"It's time to get out from the solar system",10000,12000,2000,4.99,20,60,1.99
"5885",5885,"Elminage Gothic",10000,12000,2000,9.99,20,90,0.99
"5886",5886,"Pixel War",6000,12000,6000,0.99,100,51,0.49
"5887",5887,"Cashtronauts",10000,12000,2000,2.99,20,83,0.5
"5888",5888,"Vendetta - Curse of Raven's Cry",10000,12000,2000,29.99,20,80,5.99
"5889",5889,"Cogmind",10000,12000,2000,19.99,20,10,17.99
"5890",5890,"A Legend of Luca",9000,12000,3000,19.99,33.33,50,9.99
"5891",5891,"Wild Season",10000,12000,2000,16.99,20,0,16.99
"5892",5892,"Cypher",9000,12000,3000,4.99,33.33,30,3.49
"5893",5893,"御俠客 Wuxia Master",0,12000,12000,10,0,10,9
"5894",5894,"Deadly Sky",10000,12000,2000,1.99,20,75,0.49
"5895",5895,"The Islander",7000,12000,5000,2.99,71.43,33,2
"5896",5896,"Wildlife Park",9000,12000,3000,6.99,33.33,33,4.68
"5897",5897,"Shadows Peak",8000,12000,4000,9.99,50,63,3.69
"5898",5898,"Freefall Tournament",1000,12000,11000,4.99,1100,10,4.49
"5899",5899,"Bartender VR Simulator",2000,12000,10000,19.99,500,30,13.99
"5900",5900,"Serpent in the Staglands",8000,12000,4000,19.99,50,70,5.99
"5901",5901,"Battle For The Sun",9000,12000,3000,4.99,33.33,80,0.99
"5902",5902,"Please Knock on My Door",5000,12000,7000,12.99,140,50,6.49
"5903",5903,"A House of Many Doors",9000,12000,3000,10.99,33.33,70,3.29
"5904",5904,"Sentinel 3: Homeworld",9000,12000,3000,6.99,33.33,90,0.69
"5905",5905,"Disney Princess: My Fairytale Adventure",10000,12000,2000,19.99,20,70,5.99
"5906",5906,"Party Saboteurs: After Party",10000,12000,2000,9.99,20,30,6.99
"5907",5907,"Max Stern",10000,12000,2000,4.99,20,50,2.49
"5908",5908,"Majotori",8000,12000,4000,5.99,50,67,1.97
"5909",5909,"Memoranda",5000,12000,7000,14.99,140,80,2.99
"5910",5910,"Infinium Strike",4000,12000,8000,9.99,200,66,3.39
"5911",5911,"WTF",0,12000,12000,4.99,0,90,0.49
"5912",5912,"Depression The Game",0,12000,12000,1.99,0,20,1.59
"5913",5913,"Grisaia Phantom Trigger Vol.2",8000,12000,4000,14.99,50,35,9.74
"5914",5914,"Travel Mosaics 6: Christmas Around the World",0,12000,12000,0.99,0,40,0.59
"5915",5915,"Solar Battle Glargaz",4000,12000,8000,0.99,200,51,0.49
"5916",5916,"PIXELMAN",5000,12000,7000,2.99,140,75,0.74
"5917",5917,"Behind The Door",7000,12000,5000,0.99,71.43,51,0.49
"5918",5918,"Dark Parables: The Little Mermaid and the Purple Tide Collector's Edition",2000,12000,10000,9.99,500,60,3.99
"5919",5919,"UBERMOSH:SANTICIDE",0,12000,12000,2.99,0,84,0.49
"5920",5920,"Diner Mania",9000,12000,3000,3.99,33.33,87,0.51
"5921",5921,"Loading Human: Chapter 1",1000,12000,11000,39.99,1100,80,7.99
"5922",5922,"World of Darkness Preludes: Vampire and Mage",9000,11000,2000,9.99,22.22,60,3.99
"5923",5923,"Turret Architect",3000,11000,8000,4.99,266.67,90,0.49
"5924",5924,"Colorless Life",8000,11000,3000,1.99,37.5,50,0.99
"5925",5925,"Vehicle Simulator",4000,11000,7000,20,175,0,20
"5926",5926,"FEMINAZI: 3000",8000,11000,3000,0.99,37.5,51,0.49
"5927",5927,"Crest - an indirect god sim",9000,11000,2000,9.99,22.22,0,9.99
"5928",5928,"18 Wheels of Steel: Across America",7000,11000,4000,9.99,57.14,65,3.49
"5929",5929,"Without Within 2",5000,11000,6000,4.99,120,50,2.49
"5930",5930,"Wave Mechanics",8000,11000,3000,0.99,37.5,51,0.49
"5931",5931,"Poultry Panic",4000,11000,7000,0.99,175,51,0.49
"5932",5932,"Deisim",4000,11000,7000,7.99,175,50,3.99
"5933",5933,"WorldCreator",7000,11000,4000,69.99,57.14,0,69.99
"5934",5934,"Diabolic",3000,11000,8000,3.99,266.67,87,0.51
"5935",5935,"Red Baron Pack",4000,11000,7000,9.99,175,50,4.99
"5936",5936,"Warriors: Rise to Glory!",9000,11000,2000,9.99,22.22,20,7.99
"5937",5937,"SPACE HUNT",0,11000,11000,0.99,0,51,0.49
"5938",5938,"Wind Child",6000,11000,5000,5.99,83.33,90,0.51
"5939",5939,"This Grand Life",4000,11000,7000,11.99,175,30,8.39
"5940",5940,"VR Ping Pong",9000,11000,2000,9.99,22.22,85,1.49
"5941",5941,"Atomic 79",6000,11000,5000,3.99,83.33,75,0.99
"5942",5942,"Arkshot",9000,11000,2000,4.99,22.22,70,1.49
"5943",5943,"Kingdom of Aurelia: Mystery of the Poisoned Dagger",9000,11000,2000,6.99,22.22,80,1.39
"5944",5944,"Cooking Dash",9000,11000,2000,9.99,22.22,0,9.99
"5945",5945,"The Rare Nine",5000,11000,6000,3.99,120,87,0.51
"5946",5946,"Trivia Vault: Super Heroes Trivia",8000,11000,3000,0.99,37.5,51,0.49
"5947",5947,"SurvivalZ",9000,11000,2000,0.99,22.22,51,0.49
"5948",5948,"My Pet Rock",9000,11000,2000,2.99,22.22,83,0.5
"5949",5949,"BOOR",7000,11000,4000,4.99,57.14,60,1.99
"5950",5950,"Neon Brood",3000,11000,8000,0.99,266.67,51,0.49
"5951",5951,"The Orphan Dreams",7000,11000,4000,3.99,57.14,66,1.01
"5952",5952,"City Z",9000,11000,2000,3.99,22.22,65,1.39
"5953",5953,"R.B.I. Baseball 15",7000,11000,4000,19.99,57.14,0,19.99
"5954",5954,"Astervoid 2000",9000,11000,2000,4.99,22.22,90,0.49
"5955",5955,"2D Neon Cube",7000,11000,4000,1.99,57.14,75,0.49
"5956",5956,"BLED NAVALNY",5000,11000,6000,0.99,120,51,0.49
"5957",5957,"A Mortician's Tale",6000,11000,5000,9.99,83.33,50,7.49
"5958",5958,"Island Build Masters",2000,11000,9000,6.99,450,70,2.09
"5959",5959,"Tick's Tales",7000,11000,4000,7.99,57.14,75,1.99
"5960",5960,"Ballistic Tanks",9000,11000,2000,4.99,22.22,90,0.49
"5961",5961,"Sakura Sadist",5000,11000,6000,9.99,120,33,6.69
"5962",5962,"Age of Gladiators II: Death League",2000,11000,9000,19.99,450,85,2.99
"5963",5963,"Taxi",6000,11000,5000,1.99,83.33,66,0.67
"5964",5964,"CardLife: Creative Survival",0,11000,11000,19.99,0,30,13.99
"5965",5965,"The Art of Fight | 4vs4 Fast-Paced FPS",9000,11000,2000,24.99,22.22,0,24.99
"5966",5966,"Book Series - Alice in Wonderland",8000,11000,3000,4.99,37.5,60,1.99
"5967",5967,"Atomic Society",0,11000,11000,14.99,0,0,14.99
"5968",5968,"BLARP!",8000,11000,3000,2.99,37.5,0,2.99
"5969",5969,"Strain Tactics",6000,11000,5000,14.99,83.33,60,5.99
"5970",5970,"Race",4000,11000,7000,0.99,175,51,0.49
"5971",5971,"Until I Have You",7000,11000,4000,13.99,57.14,90,1.39
"5972",5972,"XenoRaptor",8000,11000,3000,9.99,37.5,70,2.99
"5973",5973,"Zombie Pinball",8000,11000,3000,4.99,37.5,75,1.24
"5974",5974,"Queen's Quest 3: The End of Dawn",9000,11000,2000,9.99,22.22,50,4.99
"5975",5975,"Cowboy's Adventure",6000,11000,5000,0.99,83.33,51,0.49
"5976",5976,"Cornflakestein",6000,11000,5000,1.99,83.33,75,0.49
"5977",5977,"Clarent Saga: Tactics",6000,11000,5000,2.99,83.33,67,0.49
"5978",5978,"Tokyo Xanadu eX+",7000,11000,4000,59.99,57.14,60,23.99
"5979",5979,"World of Mixed Martial Arts 3",6000,11000,5000,19.99,83.33,75,4.99
"5980",5980,"Cavern Kings",7000,11000,4000,9.99,57.14,0,9.99
"5981",5981,"Energy Invasion",3000,11000,8000,2.99,266.67,40,1.79
"5982",5982,"Super Space Meltdown",7000,11000,4000,3.99,57.14,0,3.99
"5983",5983,"Starlight of Aeons",5000,11000,6000,4.99,120,20,3.99
"5984",5984,"The Dropping of The Dead",6000,11000,5000,0.99,83.33,51,0.49
"5985",5985,"Crankies Workshop: Bozzbot Assembly",4000,11000,7000,0.99,175,51,0.49
"5986",5986,"Airport Madness: Time Machine",9000,11000,2000,6.99,22.22,75,1.74
"5987",5987,"Lost Lands: The Golden Curse",9000,11000,2000,6.99,22.22,65,2.44
"5988",5988,"Snakeez",8000,11000,3000,0.99,37.5,51,0.49
"5989",5989,"Mortar Howl",0,11000,11000,2.99,0,80,0.59
"5990",5990,"Alchemist's Awakening",9000,11000,2000,15.99,22.22,75,3.99
"5991",5991,"Graviteam Tactics: Mius-Front",9000,11000,2000,34.99,22.22,35,22.74
"5992",5992,"Little Witch Academia: Chamber of Time",5000,11000,6000,39.99,120,60,15.99
"5993",5993,"Last Berserker : Endless War",4000,11000,7000,0.99,175,51,0.49
"5994",5994,"World Boxing Manager",4000,11000,7000,4.99,175,20,3.99
"5995",5995,"Bunker Punks",9000,11000,2000,14.99,22.22,67,4.94
"5996",5996,"Trap Them - Sniper Edition",9000,11000,2000,3.99,22.22,80,0.79
"5997",5997,"AUTOCROSS MADNESS",1000,11000,10000,3.99,1000,80,0.79
"5998",5998,"Party Tycoon",9000,11000,2000,9.99,22.22,50,4.99
"5999",5999,"Shannon Tweed's Attack Of The Groupies",8000,11000,3000,4.99,37.5,90,0.49
"6000",6000,"Nihilist Simulator",5000,11000,6000,0.99,120,51,0.49
"6001",6001,"Sentry Knight Tactics",4000,11000,7000,4.99,175,50,2.49
"6002",6002,"Pro Pinball Ultra",7000,11000,4000,14.99,57.14,50,7.49
"6003",6003,"Yuzi Lims: anime runner",6000,11000,5000,0.99,83.33,51,0.49
"6004",6004,"Conflicks - Revolutionary Space Battles",9000,11000,2000,6.99,22.22,33,4.68
"6005",6005,"The Exorcist: Legion VR - Chapter 1: First Rites",6000,11000,5000,4.99,83.33,50,2.49
"6006",6006,"Grandpa",1000,11000,10000,3.99,1000,70,1.19
"6007",6007,"Elbub",3000,11000,8000,1.99,266.67,75,0.49
"6008",6008,"SAWKOBAN",2000,11000,9000,9.99,450,90,0.99
"6009",6009,"Hentai MineSweeper",0,11000,11000,1,0,40,0.6
"6010",6010,"Depraved",0,11000,11000,24.99,0,20,19.99
"6011",6011,"Dinosis Survival",8000,11000,3000,4.99,37.5,80,0.99
"6012",6012,"Eared Hero",9000,11000,2000,3.99,22.22,87,0.49
"6013",6013,"Archibald's Adventures",7000,11000,4000,4.99,57.14,75,1.24
"6014",6014,"Dinosaur Hunt First Blood",9000,11000,2000,4.99,22.22,90,0.49
"6015",6015,"Shaolin vs Wutang",7000,11000,4000,13.99,57.14,40,8.39
"6016",6016,"The Coma: Recut",8000,11000,3000,14.99,37.5,70,4.49
"6017",6017,"Fell Seal: Arbiter's Mark",1000,11000,10000,19.99,1000,10,17.99
"6018",6018,"Fury Unleashed",9000,11000,2000,11.99,22.22,33,8.03
"6019",6019,"CoLab",7000,11000,4000,4.99,57.14,0,4.99
"6020",6020,"MotoGP18",6000,11000,5000,49.99,83.33,50,24.99
"6021",6021,"ICY: Frostbite Edition",9000,11000,2000,12.99,22.22,85,1.94
"6022",6022,"Cyborg Invasion Shooter",3000,11000,8000,1.99,266.67,75,0.49
"6023",6023,"The Spiral Scouts",0,11000,11000,9.99,0,33,6.69
"6024",6024,"2Dark",9000,11000,2000,24.99,22.22,80,4.99
"6025",6025,"AIRHEART - Tales of broken Wings",1000,11000,10000,14.99,1000,33,10.04
"6026",6026,"Champions Of Chaos 2",4000,11000,7000,1.99,175,0,1.99
"6027",6027,"RESONANCE OF FATE/END OF ETERNITY 4K/HD EDITION",0,11000,11000,34.99,0,10,31.49
"6028",6028,"First Feudal",7000,11000,4000,14.99,57.14,15,12.74
"6029",6029,"Achievement Hunter: Darkness",9000,11000,2000,0.99,22.22,51,0.49
"6030",6030,"Perception",8000,11000,3000,19.99,37.5,75,4.99
"6031",6031,"MHRD",9000,11000,2000,9.99,22.22,25,7.49
"6032",6032,"Necrosphere",3000,11000,8000,4.99,266.67,50,2.49
"6033",6033,"Purple Heart",4000,11000,7000,1.99,175,75,0.49
"6034",6034,"Eternity Warriors VR",7000,11000,4000,14.99,57.14,40,8.99
"6035",6035,"Please close the doors",9000,11000,2000,1.49,22.22,67,0.49
"6036",6036,"Vatnik Simulator - A Russian Patriot Game",0,11000,11000,0.99,0,51,0.49
"6037",6037,"Consummate:Missing World",7000,11000,4000,2.99,57.14,60,1.19
"6038",6038,"Chess 2: The Sequel",9000,11000,2000,5.99,22.22,50,2.99
"6039",6039,"Enlightenment",7000,11000,4000,11.99,57.14,40,7.19
"6040",6040,"Terraforming Mars",0,11000,11000,24.99,0,0,24.99
"6041",6041,"Fight'N Rage",7000,11000,4000,19.99,57.14,50,9.99
"6042",6042,"Vortex Attack: ボルテックスアタック",4000,11000,7000,7.99,175,80,1.59
"6043",6043,"The Mims Beginning",9000,11000,2000,16.99,22.22,90,1.69
"6044",6044,"Super Helmets on Fire DX Ultra Edition Plus Alpha",9000,11000,2000,0.99,22.22,0,0.99
"6045",6045,"Pure Mind",9000,11000,2000,5.99,22.22,90,0.59
"6046",6046,"Ding Dong XL",1000,11000,10000,0.99,1000,51,0.49
"6047",6047,"Isotiles - Isometric Puzzle Game",6000,11000,5000,1.99,83.33,75,0.49
"6048",6048,"Keyboard Killers",9000,11000,2000,0.99,22.22,51,0.49
"6049",6049,"Eisenhorn: XENOS",6000,11000,5000,19.99,83.33,0,19.99
"6050",6050,"Nuts!: The Battle of the Bulge",9000,11000,2000,9.99,22.22,75,2.49
"6051",6051,"Miaou Moon",7000,11000,4000,5.99,57.14,70,1.79
"6052",6052,"Rot Gut",9000,11000,2000,1.99,22.22,30,1.39
"6053",6053,"Nation War:Chronicles | 国战:列国志传",4000,11000,7000,10.99,175,40,6.59
"6054",6054,"Pain Train PainPocalypse",8000,11000,3000,0.99,37.5,51,0.49
"6055",6055,"Rezrog",5000,11000,6000,9.99,120,75,2.49
"6056",6056,"Prime Arena",8000,11000,3000,9.99,37.5,70,2.99
"6057",6057,"In Fear I Trust",5000,11000,6000,3.99,120,77,0.91
"6058",6058,"Questerium: Sinister Trinity HD Collector's Edition",8000,11000,3000,6.99,37.5,90,0.69
"6059",6059,"Westboro",6000,11000,5000,17.99,83.33,90,1.79
"6060",6060,"The Crooked Man",5000,11000,6000,2.99,120,20,2.39
"6061",6061,"Super Dungeon Run",9000,11000,2000,4.99,22.22,0,4.99
"6062",6062,"ROAD HOMEWARD",0,11000,11000,0.99,0,70,0.54
"6063",6063,"CrazyCar",7000,11000,4000,5.99,57.14,75,1.49
"6064",6064,"Rage of the Pumpkins",0,11000,11000,1.99,0,40,1.19
"6065",6065,"XenoBloom",8000,11000,3000,4.99,37.5,50,2.49
"6066",6066,"Simulator gas station",8000,11000,3000,0.99,37.5,51,0.49
"6067",6067,"Corona Blossom Vol.1 Gift From the Galaxy",9000,11000,2000,9.99,22.22,55,4.49
"6068",6068,"OPUS: Rocket of Whispers",6000,11000,5000,8.99,83.33,40,5.39
"6069",6069,"Army of Pixels",7000,11000,4000,4.99,57.14,0,4.99
"6070",6070,"ArcBall 3: Infinity",0,11000,11000,0.99,0,51,0.49
"6071",6071,"Racket: Nx",9000,11000,2000,19.99,22.22,35,12.99
"6072",6072,"18 Wheels of Steel: Extreme Trucker 2",7000,11000,4000,9.99,57.14,65,3.49
"6073",6073,"Bladestar",5000,11000,6000,9.99,120,90,0.99
"6074",6074,"Grimmwood - They Come at Night",0,11000,11000,14.99,0,50,7.49
"6075",6075,"Factory Engineer",9000,11000,2000,9.99,22.22,66,3.39
"6076",6076,"Putt-Putt and Pep's Dog on a Stick",1000,11000,10000,4.99,1000,60,1.99
"6077",6077,"The Station",3000,11000,8000,14.99,266.67,60,5.99
"6078",6078,"Barrow Hill: The Dark Path",5000,11000,6000,14.99,120,80,2.99
"6079",6079,"Magic Forest",9000,11000,2000,0.99,22.22,35,0.64
"6080",6080,"Endless Road",1000,11000,10000,9.99,1000,30,6.99
"6081",6081,"Vision Therapy VR",7000,11000,4000,2.99,57.14,0,2.99
"6082",6082,"Corona Blossom Vol.2 The Truth From Beyond",9000,11000,2000,9.99,22.22,50,4.99
"6083",6083,"Omicroid",0,11000,11000,4.99,0,0,4.99
"6084",6084,"Dead Alliance",7000,11000,4000,24.99,57.14,80,4.99
"6085",6085,"Wayward Terran Frontier: Zero Falls",6000,11000,5000,29.99,83.33,40,17.99
"6086",6086,"Raise Your Own Clone",9000,11000,2000,0.99,22.22,45,0.54
"6087",6087,"I Am Vegend - Zombiegeddon",9000,11000,2000,1.99,22.22,75,0.49
"6088",6088,"Thirst VR",8000,11000,3000,2.99,37.5,50,1.49
"6089",6089,"AGON - The Lost Sword of Toledo",8000,11000,3000,9.99,37.5,50,4.99
"6090",6090,"Dragonpath",9000,11000,2000,7.99,22.22,80,1.59
"6091",6091,"Killing Floor: Incursion",8000,10000,2000,29.99,25,67,9.89
"6092",6092,"Confederate Express",3000,10000,7000,9.99,233.33,75,2.49
"6093",6093,"Juice Fresh",7000,10000,3000,0.99,42.86,51,0.49
"6094",6094,"Ratty Catty",7000,10000,3000,14.99,42.86,75,3.74
"6095",6095,"#WarGames",4000,10000,6000,2.99,150,30,2.09
"6096",6096,"Akihabara - Feel the Rhythm",8000,10000,2000,4.99,25,50,2.49
"6097",6097,"VoiceBot",8000,10000,2000,12.99,25,50,6.49
"6098",6098,"Abduction Action! Plus",7000,10000,3000,1.99,42.86,50,0.99
"6099",6099,"Revhead",7000,10000,3000,19.99,42.86,75,4.99
"6100",6100,"Gil's Lucid Dreams",1000,10000,9000,0.99,900,50,0.59
"6101",6101,"Rescue From Goblin Deep",5000,10000,5000,8.99,100,0,8.99
"6102",6102,"Direct",6000,10000,4000,0.99,66.67,51,0.49
"6103",6103,"Kicking Kittens: Putin Saves The World",1000,10000,9000,0.99,900,51,0.49
"6104",6104,"A Light in the Dark",3000,10000,7000,14.99,233.33,25,11.24
"6105",6105,"Dokkaebi Hentai Adventures",7000,10000,3000,0.99,42.86,51,0.49
"6106",6106,"Requiem: Avenging Angel",6000,10000,4000,9.99,66.67,80,1.99
"6107",6107,"Super Robolom",2000,10000,8000,0.99,400,51,0.49
"6108",6108,"七人杀阵 - Seven Sacrifices",0,10000,10000,6.99,0,40,4.19
"6109",6109,"My Ex-Boyfriend the Space Tyrant",3000,10000,7000,14.99,233.33,70,4.49
"6110",6110,"Zup! S",0,10000,10000,0.99,0,15,0.84
"6111",6111,"RIDE 3",0,10000,10000,49.99,0,0,49.99
"6112",6112,"Wizhood",5000,10000,5000,1.99,100,75,0.49
"6113",6113,"The Fall Part 2: Unbound",7000,10000,3000,16.99,42.86,50,8.49
"6114",6114,"Adam's Venture: Origins",6000,10000,4000,17.99,66.67,90,1.79
"6115",6115,"Planet Alcatraz 2",8000,10000,2000,4.99,25,75,1.24
"6116",6116,"Rush Rover",6000,10000,4000,4.99,66.67,15,4.24
"6117",6117,"Hardcore Survival",8000,10000,2000,2.99,25,75,0.74
"6118",6118,"ORIX!",1000,10000,9000,0.99,900,51,0.49
"6119",6119,"Wolf Tails",5000,10000,5000,9.99,100,25,7.49
"6120",6120,"CounterAttack",7000,10000,3000,7.99,42.86,33,5.35
"6121",6121,"Protolife",4000,10000,6000,11.99,150,10,10.79
"6122",6122,"ORION",3000,10000,7000,0.99,233.33,51,0.49
"6123",6123,"Pixel Game Maker MV / アクションゲームツクールMV",0,10000,10000,84.99,0,20,67.99
"6124",6124,"ReCore: Definitive Edition",0,10000,10000,19.99,0,25,14.99
"6125",6125,"Hostil",3000,10000,7000,2.99,233.33,30,2.09
"6126",6126,"Fenimore Fillmore: The Westerner",2000,10000,8000,9.99,400,80,1.99
"6127",6127,"Christmas Race",4000,10000,6000,0.99,150,51,0.49
"6128",6128,"Starway Fleet",3000,10000,7000,9.99,233.33,50,4.99
"6129",6129,"Caladrius Blaze",8000,10000,2000,24.99,25,85,3.74
"6130",6130,"Slice of Life",1000,10000,9000,4.99,900,70,1.49
"6131",6131,"Sliver-Sclicker",2000,10000,8000,0.99,400,51,0.49
"6132",6132,"Underground Bone Marrow",0,10000,10000,1.99,0,75,0.49
"6133",6133,"Crimson Survival",4000,10000,6000,0.99,150,51,0.49
"6134",6134,"Soul Saber 2",6000,10000,4000,9.99,66.67,50,4.99
"6135",6135,"Franchise Hockey Manager 4",8000,10000,2000,19.99,25,90,1.99
"6136",6136,"Juanito Arcade Mayhem",6000,10000,4000,9.99,66.67,50,4.99
"6137",6137,"Firewood",6000,10000,4000,4.99,66.67,75,1.24
"6138",6138,"The East New World",2000,10000,8000,4.99,400,70,1.49
"6139",6139,"Willy-Nilly Knight",7000,10000,3000,14.99,42.86,72,4.19
"6140",6140,"PUTIN, BOOBS and TRUMP",5000,10000,5000,0.99,100,51,0.49
"6141",6141,"Unending Galaxy",6000,10000,4000,8.99,66.67,80,1.79
"6142",6142,"Excubitor",4000,10000,6000,14.99,150,85,2.24
"6143",6143,"Leisure Suit Larry - Wet Dreams Don't Dry",0,10000,10000,29.99,0,15,25.49
"6144",6144,"Battle Chess: Game of Kings",8000,10000,2000,29.99,25,66,10.19
"6145",6145,"CastleMiner Warfare",6000,10000,4000,4.99,66.67,80,0.99
"6146",6146,"Delicious - Emily's Miracle of Life",6000,10000,4000,12.99,66.67,50,6.49
"6147",6147,"Double Memory",3000,10000,7000,0.99,233.33,51,0.49
"6148",6148,"Atelier Lydie & Suelle ~The Alchemists and the Mysterious Paintings~",6000,10000,4000,59.99,66.67,30,41.99
"6149",6149,"Tales of Aravorn: Seasons Of The Wolf",3000,10000,7000,24.99,233.33,75,6.24
"6150",6150,"M.A.C.E.",8000,10000,2000,4.99,25,70,1.49
"6151",6151,"Block Survival: Legend of the Lost Islands",6000,10000,4000,4.99,66.67,80,0.99
"6152",6152,"Wild Guns Reloaded",6000,10000,4000,14.99,66.67,50,7.49
"6153",6153,"UnderDread",3000,10000,7000,4.99,233.33,90,0.49
"6154",6154,"Time Tenshi",6000,10000,4000,9.99,66.67,75,2.49
"6155",6155,"Anomaly 1729",8000,10000,2000,9.99,25,0,9.99
"6156",6156,"A Pixel Story",7000,10000,3000,11.99,42.86,90,1.19
"6157",6157,"三国游侠志",4000,10000,6000,5.99,150,50,2.99
"6158",6158,"Trivia Vault: Video Game Trivia Deluxe",5000,10000,5000,4.99,100,90,0.49
"6159",6159,"Mountain Troll",7000,10000,3000,3.99,42.86,87,0.5
"6160",6160,"Boat Adventure",2000,10000,8000,0.99,400,51,0.49
"6161",6161,"Fix Me Fix You",2000,10000,8000,6.99,400,75,1.74
"6162",6162,"Potato Thriller",8000,10000,2000,2.99,25,25,2.24
"6163",6163,"Adventure in the Tower of Flight",8000,10000,2000,4.99,25,60,1.99
"6164",6164,"360 No Scope Arena",0,10000,10000,0.99,0,25,0.74
"6165",6165,"Nightshade／百花百狼",6000,10000,4000,34.99,66.67,20,27.99
"6166",6166,"Battlezone Gold Edition",8000,10000,2000,34.99,25,66,11.89
"6167",6167,"Empire Architect",7000,10000,3000,14.99,42.86,55,6.74
"6168",6168,"Animallica",8000,10000,2000,19.99,25,50,9.99
"6169",6169,"Tower!3D Pro",7000,10000,3000,49.99,42.86,60,19.99
"6170",6170,"Project LUX",7000,10000,3000,24.99,42.86,35,16.24
"6171",6171,"Game Dev Studio",3000,10000,7000,9.99,233.33,65,3.49
"6172",6172,"Equalizer",6000,10000,4000,6.99,66.67,85,1.04
"6173",6173,"Akuya",6000,10000,4000,1.99,66.67,0,1.99
"6174",6174,"Achievement Clicker 2019",4000,10000,6000,0.99,150,51,0.49
"6175",6175,"Four Sided Fantasy",8000,10000,2000,9.99,25,80,1.99
"6176",6176,"If you know what I mean",3000,10000,7000,0.99,233.33,51,0.49
"6177",6177,"Epanalepsis",2000,10000,8000,3.99,400,75,0.99
"6178",6178,"异种战争少女 Alien War Girl",0,10000,10000,3.99,0,40,2.39
"6179",6179,"Trivia Vault: Science & History Trivia",7000,10000,3000,0.99,42.86,51,0.49
"6180",6180,"Chess Ultra",8000,10000,2000,12.99,25,60,5.19
"6181",6181,"Inner Voices",5000,10000,5000,9.99,100,50,4.99
"6182",6182,"ZhanDou (VR and Non-VR)",8000,10000,2000,9.99,25,50,4.99
"6183",6183,"The Astonishing Game",6000,10000,4000,2.99,66.67,0,2.99
"6184",6184,"Karaski: What Goes Up...",6000,10000,4000,11.99,66.67,70,3.59
"6185",6185,"Anubis Dungeon",8000,10000,2000,0.99,25,51,0.49
"6186",6186,"Shoppy Mart: Steam Edition",7000,10000,3000,1.99,42.86,75,0.49
"6187",6187,"Cunning Fox",7000,10000,3000,3.99,42.86,87,0.49
"6188",6188,"Higurashi When They Cry Hou - Ch.6 Tsumihoroboshi",2000,10000,8000,7.99,400,50,3.99
"6189",6189,"NOBUNAGA'S AMBITION: Tenshouki WPK HD Version / 信長の野望・天翔記 with パワーアップキット HD Version",7000,10000,3000,54.99,42.86,50,27.49
"6190",6190,"Selma and the Wisp",7000,10000,3000,9.99,42.86,70,2.99
"6191",6191,"Labyrinth of Refrain: Coven of Dusk / ルフランの地下迷宮と魔女ノ旅団",0,10000,10000,49.99,0,20,39.99
"6192",6192,"A Rose in the Twilight / ロゼと黄昏の古城",7000,10000,3000,19.99,42.86,60,7.99
"6193",6193,"Frozen Synapse 2",0,10000,10000,29.99,0,10,26.99
"6194",6194,"Aliens&Asteroids",8000,10000,2000,1.99,25,50,0.99
"6195",6195,"Trivia Vault: 1980's Trivia",7000,10000,3000,0.99,42.86,51,0.49
"6196",6196,"Creed: Rise to Glory",0,10000,10000,29.99,0,20,23.99
"6197",6197,"Typing game",0,10000,10000,0.99,0,51,0.49
"6198",6198,"Rabbit Island",8000,10000,2000,1.99,25,75,0.49
"6199",6199,"Star Sky 2 - ブルームーン 2",8000,10000,2000,3.99,25,75,0.99
"6200",6200,"Idle Civilization",8000,10000,2000,4.99,25,0,4.99
"6201",6201,"SimpleRockets 2",0,10000,10000,14.99,0,15,12.74
"6202",6202,"Ninja Stealth 3",8000,10000,2000,0.99,25,51,0.49
"6203",6203,"Amaranthine",8000,10000,2000,2.99,25,70,0.89
"6204",6204,"Fitzzle Regal Tigers",0,10000,10000,2.99,0,80,0.59
"6205",6205,"Nazi Bunker",0,10000,10000,0.99,0,51,0.49
"6206",6206,"Masters of Anima",4000,10000,6000,19.99,150,60,7.99
"6207",6207,"Hello Charlotte EP2: Requiem Aeternam Deo",4000,10000,6000,2.99,150,50,1.49
"6208",6208,"Spark the Electric Jester",5000,10000,5000,7.99,100,55,3.59
"6209",6209,"弹幕音乐绘 ～风雷幻奏曲～ / Barrage Musical ~A Fantasy of Tempest~",7000,10000,3000,9.99,42.86,55,4.49
"6210",6210,"SharpShooter3D",0,10000,10000,5.99,0,66,2.03
"6211",6211,"Edge Of Eternity",0,10000,10000,19.99,0,10,17.99
"6212",6212,"Call to Power II",1000,10000,9000,5.99,900,20,4.79
"6213",6213,"Whiplash - Crash Valley",8000,10000,2000,4.99,25,75,1.49
"6214",6214,"Community Inc",7000,10000,3000,14.99,42.86,67,4.94
"6215",6215,"STEEL STRIDER",3000,10000,7000,5.99,233.33,50,2.99
"6216",6216,"On Board Remastered",0,10000,10000,0.99,0,40,0.59
"6217",6217,"Hatch and Slay",8000,10000,2000,1.99,25,0,1.99
"6218",6218,"Aerospace Forces",5000,10000,5000,0.99,100,51,0.49
"6219",6219,"Dawn of Andromeda",8000,10000,2000,29.99,25,75,7.49
"6220",6220,"Short Stories Collection of Class Tangerine",6000,10000,4000,7.99,66.67,35,5.19
"6221",6221,"Keplerth",5000,10000,5000,12.99,100,25,9.74
"6222",6222,"The Hurricane of the Varstray -Collateral hazard-",8000,10000,2000,9.99,25,80,1.99
"6223",6223,"Monkey Slap",2000,10000,8000,1.99,400,75,0.49
"6224",6224,"Let There Be Life",7000,10000,3000,5.99,42.86,0,5.99
"6225",6225,"巴伦西亚传说：索菲亚的重生 Valencia Saga:Sophia's rebirth",0,10000,10000,8.99,0,35,5.84
"6226",6226,"Tube Tycoon",5000,10000,5000,10.99,100,30,7.69
"6227",6227,"Straima",7000,10000,3000,4.99,42.86,65,2.44
"6228",6228,"Touhou: Scarlet Curiosity | 東方紅輝心",0,10000,10000,14.99,0,35,9.74
"6229",6229,"The Admin",5000,10000,5000,1.99,100,50,0.99
"6230",6230,"月夜下的紅茶杯 ~ Blacktea With Moon",7000,10000,3000,0.99,42.86,51,0.49
"6231",6231,"Tyler",8000,10000,2000,2.99,25,66,1.01
"6232",6232,"This Strange Realm Of Mine",7000,10000,3000,12.99,42.86,90,1.29
"6233",6233,"Depth Siege Atlantis",2000,10000,8000,0.99,400,51,0.49
"6234",6234,"Golf Extreme",6000,10000,4000,1.99,66.67,75,0.49
"6235",6235,"Spoko and Poko",6000,10000,4000,3.99,66.67,0,3.99
"6236",6236,"Mastema: Out of Hell",8000,10000,2000,4.99,25,90,0.49
"6237",6237,"G-senjou no Maou - The Devil on G-String",8000,10000,2000,19.99,25,50,9.99
"6238",6238,"Broken Armor",6000,10000,4000,4.99,66.67,80,0.49
"6239",6239,"LineWay",7000,10000,3000,0.99,42.86,30,0.69
"6240",6240,"Inmates",7000,10000,3000,9.99,42.86,75,2.49
"6241",6241,"Worst Case Z",8000,10000,2000,12.99,25,90,1.29
"6242",6242,"The Search for Amelia Earhart",8000,10000,2000,6.99,25,80,1.39
"6243",6243,"One Tank to Rule Them All",7000,10000,3000,4.99,42.86,30,3.49
"6244",6244,"NaziShoot",7000,10000,3000,1.99,42.86,50,0.99
"6245",6245,"The Adventure Pals",6000,10000,4000,14.99,66.67,34,9.89
"6246",6246,"The Tower",7000,10000,3000,2.99,42.86,0,2.99
"6247",6247,"She Wants Me Dead",7000,10000,3000,7.99,42.86,50,3.99
"6248",6248,"Demon Peak",5000,10000,5000,4.99,100,50,2.49
"6249",6249,"KILL THE EMOJI",5000,10000,5000,2.99,100,50,1.49
"6250",6250,"Captain Kaon",7000,10000,3000,6.99,42.86,0,6.99
"6251",6251,"Marcus Level",4000,10000,6000,4.99,150,75,1.24
"6252",6252,"Zomborg",4000,10000,6000,4.99,150,90,0.49
"6253",6253,"Love's Sweet Garnish",0,10000,10000,12.99,0,15,11.04
"6254",6254,"Archery Blast",4000,10000,6000,0.99,150,51,0.49
"6255",6255,"Trivia Vault: Classic Rock Trivia 2",6000,10000,4000,0.99,66.67,51,0.49
"6256",6256,"Pinball FX2 VR",7000,10000,3000,14.99,42.86,60,5.99
"6257",6257,"Starblast",3000,10000,7000,9.99,233.33,75,2.49
"6258",6258,"AffordaGolf Online",6000,10000,4000,1.99,66.67,75,0.49
"6259",6259,"Timberman VS",0,10000,10000,1.99,0,75,0.49
"6260",6260,"NASCAR Heat 2",8000,10000,2000,19.99,25,0,19.99
"6261",6261,"Dustwind",4000,10000,6000,24.99,150,40,14.39
"6262",6262,"Cavern of Time",8000,10000,2000,3.99,25,88,0.49
"6263",6263,"Star Advent",8000,10000,2000,0.99,25,51,0.49
"6264",6264,"Gunheart",8000,10000,2000,29.99,25,30,20.99
"6265",6265,"Monster RPG 2",8000,10000,2000,1.99,25,66,0.67
"6266",6266,"Crash Dive",8000,10000,2000,6.99,25,25,5.24
"6267",6267,"Cards of Cthulhu",6000,10000,4000,1.99,66.67,70,0.59
"6268",6268,"CTU: Counter Terrorism Unit",5000,10000,5000,4.99,100,80,1.49
"6269",6269,"One-Way Ticket / 单程票",0,10000,10000,4.99,0,20,3.99
"6270",6270,"Magma Chamber",6000,10000,4000,4.99,66.67,0,4.99
"6271",6271,"No Heroes Here",4000,10000,6000,14.99,150,90,1.49
"6272",6272,"Donuts'n'Justice",6000,10000,4000,4.99,66.67,66,1.69
"6273",6273,"Meridian: Squad 22",8000,10000,2000,14.99,25,80,2.99
"6274",6274,"Doodle God: Alchemy Jam",7000,10000,3000,0.99,42.86,40,0.59
"6275",6275,"Cyber Team Manager",4000,10000,6000,4.99,150,90,0.49
"6276",6276,"Star Nomad",8000,10000,2000,0.99,25,0,0.99
"6277",6277,"Hold Your Own",4000,10000,6000,14.99,150,40,8.99
"6278",6278,"A Healer Only Lives Twice",8000,10000,2000,4.99,25,50,2.49
"6279",6279,"Castle Must Be Mine",8000,10000,2000,15.99,25,30,11.19
"6280",6280,"Simple Story - Alex",3000,10000,7000,2.99,233.33,84,0.49
"6281",6281,"Cobalt WASD",7000,10000,3000,6.99,42.86,0,6.99
"6282",6282,"Little Busters! English Edition",8000,10000,2000,34.99,25,30,24.49
"6283",6283,"WOLFLAME",2000,10000,8000,5.99,400,50,2.99
"6284",6284,"ALICE VR",8000,10000,2000,9.99,25,75,2.49
"6285",6285,"Fjong",8000,10000,2000,1.99,25,75,0.49
"6286",6286,"Cat's Bar",7000,10000,3000,1.99,42.86,50,0.99
"6287",6287,"Super Indie Karts",8000,10000,2000,14.99,25,50,4.99
"6288",6288,"Fidget Spinner",8000,10000,2000,0.99,25,51,0.49
"6289",6289,"Mosaic: Game of Gods",8000,10000,2000,2.99,25,75,0.74
"6290",6290,"Blaster Simulator",8000,10000,2000,4.99,25,75,1.24
"6291",6291,"Reaching for Petals: VR Edition",6000,10000,4000,4.99,66.67,55,2.24
"6292",6292,"Unforgiving - A Northern Hymn",7000,10000,3000,14.99,42.86,75,3.74
"6293",6293,"Pegasus-5: Gone Astray",0,10000,10000,6.99,0,50,3.49
"6294",6294,"Avernum 3: Ruined World",8000,10000,2000,19.99,25,25,14.99
"6295",6295,"Adventures of Bertram Fiddle: Episode 2: A Bleaker Predicklement",8000,10000,2000,9.99,25,75,3.74
"6296",6296,"Your Smile Beyond Twilight:黄昏下的月台上",8000,10000,2000,1.99,25,30,1.39
"6297",6297,"Zooloretto",6000,10000,4000,2.99,66.67,70,0.89
"6298",6298,"Minimon",6000,10000,4000,9.99,66.67,0,9.99
"6299",6299,"Omega Quintet",6000,10000,4000,29.99,66.67,60,11.99
"6300",6300,"Alwa's Awakening",8000,10000,2000,9.99,25,45,5.49
"6301",6301,"Extreme-G 2",3000,10000,7000,5.99,233.33,60,2.39
"6302",6302,"Crucible Falls: Together Forever",2000,10000,8000,4.99,400,25,3.74
"6303",6303,"BOOKS",5000,10000,5000,0.99,100,51,0.49
"6304",6304,"SQR",8000,10000,2000,0.99,25,51,0.49
"6305",6305,"Bunny Bounce",8000,10000,2000,5.99,25,60,2.19
"6306",6306,"Daytona Racing",0,10000,10000,0.99,0,51,0.49
"6307",6307,"Scarlett Mysteries: Cursed Child",5000,10000,5000,9.99,100,60,3.99
"6308",6308,"Dogolrax",6000,10000,4000,4.99,66.67,80,0.99
"6309",6309,"Quad Hopping",7000,10000,3000,0.99,42.86,51,0.49
"6310",6310,"DarkLast",5000,10000,5000,0.99,100,80,0.99
"6311",6311,"Let's zig zag",4000,10000,6000,0.99,150,51,0.49
"6312",6312,"Lopp",5000,10000,5000,0.99,100,51,0.49
"6313",6313,"拼词游戏 2017",3000,10000,7000,0.99,233.33,51,0.49
"6314",6314,"Undercover Missions: Operation Kursk K-141",3000,10000,7000,9.99,233.33,75,2.49
"6315",6315,"Pull Me Out",0,10000,10000,0.99,0,51,0.49
"6316",6316,"Reborn In Wild City 迷城重生",0,10000,10000,4.99,0,20,3.99
"6317",6317,"Hacktag",6000,10000,4000,19.99,66.67,50,9.99
"6318",6318,"F-19 Stealth Fighter",6000,10000,4000,6.99,66.67,75,1.74
"6319",6319,"Crystal Cosmos",7000,10000,3000,4.99,42.86,85,0.74
"6320",6320,"Chicken Invaders 2",8000,10000,2000,3.99,25,50,1.99
"6321",6321,"Super Dungeon Bros",5000,10000,5000,19.99,100,75,4.99
"6322",6322,"Gravel",5000,9000,4000,49.99,80,70,14.99
"6323",6323,"Space Thinger",6000,9000,3000,1.99,50,50,0.99
"6324",6324,"Zafehouse Diaries 2",7000,9000,2000,6.99,28.57,30,4.89
"6325",6325,"MIRAGE",0,9000,9000,4.99,0,60,2.39
"6326",6326,"Art of Murder - Hunt for the Puppeteer",0,9000,9000,4.99,0,55,2.24
"6327",6327,"The Path of Greatest Resistance",4000,9000,5000,3.99,125,40,2.39
"6328",6328,"e-River Cabin Journal",1000,9000,8000,9.99,800,0,9.99
"6329",6329,"Precision Archery: Competitive",1000,9000,8000,1.99,800,50,0.99
"6330",6330,"Silence in Space - Season One",0,9000,9000,1.99,0,60,0.79
"6331",6331,"Highland Warriors",7000,9000,2000,7.99,28.57,70,2.39
"6332",6332,"Jump to the circle",3000,9000,6000,0.99,200,51,0.49
"6333",6333,"Cave Adventures",1000,9000,8000,0.99,800,51,0.49
"6334",6334,"18 Wheels of Steel: Convoy",5000,9000,4000,9.99,80,65,3.49
"6335",6335,"Bucket Detective",6000,9000,3000,3.99,50,66,1.35
"6336",6336,"STELLATUM",3000,9000,6000,2.99,200,50,1.49
"6337",6337,"Desktop Mascot Engine",5000,9000,4000,2.99,80,33,1.33
"6338",6338,"Daddy's gone a-hunting",6000,9000,3000,0.99,50,51,0.49
"6339",6339,"Disney Bolt",6000,9000,3000,19.99,50,70,5.99
"6340",6340,"Soldiers of the Universe",4000,9000,5000,4.99,125,50,2.49
"6341",6341,"Black Hole Hazard",2000,9000,7000,4.99,350,80,0.99
"6342",6342,"Kingdom Elemental",3000,9000,6000,3.99,200,0,3.99
"6343",6343,"Bystander",5000,9000,4000,2.99,80,83,0.5
"6344",6344,"Red Forest",7000,9000,2000,4.99,28.57,90,0.49
"6345",6345,"Super Robot Jump Jump",6000,9000,3000,4.99,50,90,0.49
"6346",6346,"ATOMINE",6000,9000,3000,9.99,50,80,1.99
"6347",6347,"Warsim: The Realm of Aslona",7000,9000,2000,4.99,28.57,59,2.04
"6348",6348,"Hardware Engineering",6000,9000,3000,4.99,50,45,2.99
"6349",6349,"Polynomial 2 - Universe of the Music",7000,9000,2000,11.99,28.57,25,8.99
"6350",6350,"PLUTONIUM",6000,9000,3000,1.99,50,66,0.67
"6351",6351,"Ys: Memories of Celceta",0,9000,9000,24.99,0,25,18.74
"6352",6352,"The Last Day Defense",0,9000,9000,19.99,0,0,19.99
"6353",6353,"Wonderful Everyday Down the Rabbit-Hole",7000,9000,2000,29.99,28.57,40,17.99
"6354",6354,"Wild Animals - Animated Jigsaws",7000,9000,2000,9.99,28.57,90,0.99
"6355",6355,"Obscurity",1000,9000,8000,0.99,800,51,0.49
"6356",6356,"Dungeons and Robots",7000,9000,2000,8.99,28.57,85,1.34
"6357",6357,"Mahjong Club",0,9000,9000,4.99,0,20,3.99
"6358",6358,"Veer",7000,9000,2000,2.99,28.57,0,2.99
"6359",6359,"Miniature - The Story Puzzle",7000,9000,2000,3.99,28.57,75,0.99
"6360",6360,"Skyraine",3000,9000,6000,1.99,200,0,1.99
"6361",6361,"My Coloring Book: Professions",4000,9000,5000,0.99,125,51,0.49
"6362",6362,"Independence War 2: Edge of Chaos",6000,9000,3000,5.99,50,66,2.03
"6363",6363,"Znkl - 177",5000,9000,4000,0.99,80,51,0.49
"6364",6364,"Welcome Back To 2007",4000,9000,5000,1.99,125,75,0.49
"6365",6365,"Aliens Go Home Run",7000,9000,2000,3.99,28.57,50,1.99
"6366",6366,"Babel: Choice",2000,9000,7000,9.99,350,90,0.99
"6367",6367,"Pixeluvo",7000,9000,2000,34.99,28.57,75,8.74
"6368",6368,"Skautfold: Usurper",7000,9000,2000,9.99,28.57,70,2.99
"6369",6369,"Impact Winter",7000,9000,2000,19.99,28.57,75,4.99
"6370",6370,"Last Heroes 3",6000,9000,3000,2.99,50,83,0.5
"6371",6371,"KovaaK's FPS Aim Trainer",3000,9000,6000,9.99,200,35,6.49
"6372",6372,"Romancing SaGa 2",5000,9000,4000,24.99,80,25,18.74
"6373",6373,"RutonyChat",7000,9000,2000,14.99,28.57,20,11.99
"6374",6374,"Sloppy Goat",3000,9000,6000,0.99,200,51,0.49
"6375",6375,"Raptor Valley",7000,9000,2000,8.99,28.57,80,1.79
"6376",6376,"Never Again",7000,9000,2000,7.99,28.57,50,3.99
"6377",6377,"3D Tower",4000,9000,5000,0.99,125,83,0.49
"6378",6378,"A-Tech Cybernetic VR",7000,9000,2000,24.99,28.57,33,16.74
"6379",6379,"Camper Jumper Simulator",5000,9000,4000,2.99,80,80,0.59
"6380",6380,"Don't Tax Me, Bro!",6000,9000,3000,2.99,50,75,0.74
"6381",6381,"Space Pilgrim Academy: Year 1",6000,9000,3000,1.99,50,50,0.99
"6382",6382,"Circularity",5000,9000,4000,0.99,80,51,0.49
"6383",6383,"Black Mirror",6000,9000,3000,29.99,50,50,14.99
"6384",6384,"Gettysburg: The Tide Turns",3000,9000,6000,9.99,200,51,4.89
"6385",6385,"Over The Hills And Far Away",7000,9000,2000,8.99,28.57,50,4.49
"6386",6386,"ARSLAN: THE WARRIORS OF LEGEND",7000,9000,2000,59.99,28.57,50,29.99
"6387",6387,"Grail to the Thief",7000,9000,2000,2.99,28.57,75,0.74
"6388",6388,"CloudCity VR",2000,9000,7000,11.99,350,75,2.99
"6389",6389,"Deadlands Noir - That Old Time Religion",6000,9000,3000,0.99,50,51,0.49
"6390",6390,"Star Trek: Judgment Rites",6000,9000,3000,9.99,50,30,6.99
"6391",6391,"AHEGAL",0,9000,9000,0.99,0,40,0.59
"6392",6392,"C.R.E.E.P.S",4000,9000,5000,11.99,125,0,11.99
"6393",6393,"Pilot Brothers 3: Back Side of the Earth",6000,9000,3000,4.99,50,75,1.24
"6394",6394,"Political Animals",7000,9000,2000,14.99,28.57,60,5.99
"6395",6395,"The Quivering",6000,9000,3000,3.99,50,50,1.99
"6396",6396,"Recursed",3000,9000,6000,7.99,200,66,2.71
"6397",6397,"Store Simulator 2018",5000,9000,4000,0.99,80,45,0.54
"6398",6398,"Hentai University",0,9000,9000,1.99,0,75,0.49
"6399",6399,"Australian trip",2000,9000,7000,0.99,350,60,0.99
"6400",6400,"StellarHub",3000,9000,6000,8.99,200,50,4.49
"6401",6401,"Silent Service",5000,9000,4000,6.99,80,75,1.74
"6402",6402,"Shred! Downhill Mountain Biking",7000,9000,2000,2.99,28.57,0,2.99
"6403",6403,"Among the Innocent: A Stricken Tale",7000,9000,2000,7.99,28.57,66,2.71
"6404",6404,"Jumpdrive",7000,9000,2000,9.99,28.57,0,9.99
"6405",6405,"Dreaming about you",7000,9000,2000,1.99,28.57,70,0.59
"6406",6406,"TOGETHER VR",4000,9000,5000,12.99,125,50,6.49
"6407",6407,"Escape First",3000,9000,6000,5.99,200,20,4.79
"6408",6408,"The Secret Order 6: Bloodline",7000,9000,2000,9.99,28.57,40,5.99
"6409",6409,"Marble Skies",4000,9000,5000,9.99,125,50,4.99
"6410",6410,"The Coma - light and darkness battleground",3000,9000,6000,0.99,200,15,0.99
"6411",6411,"21+",0,9000,9000,0.99,0,51,0.49
"6412",6412,"GLAD VALAKAS SIMULATOR",2000,9000,7000,1.99,350,70,0.59
"6413",6413,"Where the Water Tastes Like Wine",5000,9000,4000,19.99,80,40,11.99
"6414",6414,"Dracula's Library",7000,9000,2000,1.99,28.57,75,0.49
"6415",6415,"Victory At Sea Pacific",0,9000,9000,39.99,0,10,35.99
"6416",6416,"Scourge of War: Waterloo",6000,9000,3000,49.99,50,61,19.49
"6417",6417,"Don't open the doors!",5000,9000,4000,10.99,80,70,3.29
"6418",6418,"Russian World",2000,9000,7000,0.99,350,51,0.49
"6419",6419,"恒水中学连环虐杀 / The untold story of hengshui school",2000,9000,7000,3.99,350,40,2.39
"6420",6420,"Crypt of the Serpent King",3000,9000,6000,1.99,200,50,0.99
"6421",6421,"Pro Basketball Manager 2016",5000,9000,4000,14.99,80,0,14.99
"6422",6422,"Electronauts",0,9000,9000,19.99,0,50,9.99
"6423",6423,"Human Extinction Simulator",6000,9000,3000,19.99,50,75,4.99
"6424",6424,"Death's Life",6000,9000,3000,2.99,50,83,0.5
"6425",6425,"The Moment We Met",0,9000,9000,1.99,0,50,0.99
"6426",6426,"Wheels of Aurelia",5000,9000,4000,9.99,80,87,1.29
"6427",6427,"Solar System",3000,9000,6000,0.99,200,51,0.49
"6428",6428,"Wanderlust",5000,9000,4000,7.99,80,85,1.19
"6429",6429,"Gravity Error",6000,9000,3000,4.99,50,0,4.99
"6430",6430,"SURV1V3",6000,9000,3000,24.99,50,10,22.49
"6431",6431,"Mother Simulator",6000,9000,3000,1.99,50,60,0.79
"6432",6432,"Franky the Bumwalker",4000,9000,5000,1.99,125,75,0.49
"6433",6433,"Nemesis of the Roman Empire",5000,9000,4000,9.99,80,70,2.99
"6434",6434,"Trivia Vault Football Trivia",4000,9000,5000,1.99,125,75,0.49
"6435",6435,"ValeGuard",1000,9000,8000,12.99,800,50,6.49
"6436",6436,"Straimium Immortaly",7000,9000,2000,8.99,28.57,50,4.49
"6437",6437,"Beat Da Beat",7000,9000,2000,1.99,28.57,0,1.99
"6438",6438,"Tales Of Glory",4000,9000,5000,29.99,125,20,23.99
"6439",6439,"Blue Sheep",6000,9000,3000,1.99,50,0,1.99
"6440",6440,"Imperium Galactica",5000,9000,4000,4.99,80,75,1.24
"6441",6441,"Blade Ballet",6000,9000,3000,14.99,50,0,14.99
"6442",6442,"Abstractanoid",5000,9000,4000,1.99,80,75,0.49
"6443",6443,"Debris",7000,9000,2000,19.99,28.57,60,7.99
"6444",6444,"Silicone-2",5000,9000,4000,0.99,80,51,0.49
"6445",6445,"Death Toll",4000,9000,5000,9.99,125,90,0.99
"6446",6446,"Gothicc Breaker",4000,9000,5000,1.99,125,30,1.39
"6447",6447,"Pixel Puzzles Junior",6000,9000,3000,9.99,50,70,2.99
"6448",6448,"Brilliant Shadows - Part One of the Book of Gray Magic",6000,9000,3000,6.99,50,55,3.14
"6449",6449,"Ballway",7000,9000,2000,0.99,28.57,51,0.49
"6450",6450,"Voodoo Vince: Remastered",6000,9000,3000,14.99,50,66,5.09
"6451",6451,"Robot Arena III",4000,9000,5000,19.99,125,75,4.99
"6452",6452,"Mary Skelter: Nightmares",0,9000,9000,24.99,0,40,14.99
"6453",6453,"Phantom Trigger",6000,9000,3000,14.99,50,67,4.94
"6454",6454,"Redie",4000,9000,5000,9.99,125,85,1.49
"6455",6455,"NightCry",6000,9000,3000,24.99,50,60,9.99
"6456",6456,"Psi Project: Legacy",6000,9000,3000,3.99,50,90,0.49
"6457",6457,"Spacejacked",6000,9000,3000,9.99,50,50,4.99
"6458",6458,"The Pirate's Fate",4000,9000,5000,19.99,125,35,12.99
"6459",6459,"The Way We All Go",7000,9000,2000,5.99,28.57,75,1.49
"6460",6460,"Disney•Pixar Cars Mater-National Championship",6000,9000,3000,19.99,50,70,5.99
"6461",6461,"Tennis World Tour",5000,9000,4000,49.99,80,50,24.99
"6462",6462,"JET HERO",4000,9000,5000,3.99,125,55,0.69
"6463",6463,"Bermuda - Lost Survival",7000,9000,2000,14.99,28.57,10,13.49
"6464",6464,"New Gundam Breaker",0,9000,9000,49.99,0,50,24.99
"6465",6465,"Monsters Attack",3000,9000,6000,0.99,200,50,0.99
"6466",6466,"ADventure Lib",7000,9000,2000,1.99,28.57,50,0.99
"6467",6467,"The Sea Will Claim Everything",7000,9000,2000,9.99,28.57,75,2.49
"6468",6468,"Caromble!",7000,9000,2000,12.99,28.57,30,9.09
"6469",6469,"Citystate",3000,9000,6000,14.99,200,10,13.49
"6470",6470,"Gladiator School",4000,9000,5000,11.99,125,90,1.19
"6471",6471,"KAKUSANKIBOU / 扩散希望",4000,9000,5000,2.99,125,60,1.19
"6472",6472,"Labyrinthian",4000,9000,5000,0.99,125,51,0.49
"6473",6473,"The Tritan Initiative",6000,9000,3000,0.99,50,51,0.49
"6474",6474,"I Want To Be Human",6000,9000,3000,2.99,50,50,1.49
"6475",6475,"Answer The Question",0,9000,9000,0.99,0,51,0.49
"6476",6476,"Hidden Object - 12 in 1 bundle",7000,9000,2000,5.99,28.57,67,1.97
"6477",6477,"NARK THE DRAGON",3000,9000,6000,0.99,200,51,0.49
"6478",6478,"AI War 2",0,9000,9000,19.99,0,15,16.99
"6479",6479,"Football Manager 2019 Touch",0,9000,9000,29.99,0,0,29.99
"6480",6480,"Train Station Simulator",6000,9000,3000,14.99,50,50,7.49
"6481",6481,"Obscuritas",7000,9000,2000,14.99,28.57,80,2.99
"6482",6482,"Elite vs. Freedom",3000,9000,6000,4.99,200,90,0.49
"6483",6483,"Post Human W.A.R",3000,9000,6000,14.99,200,40,8.99
"6484",6484,"Bitcoin Man Clicker",0,9000,9000,0.99,0,51,0.49
"6485",6485,"The Interview",7000,9000,2000,1.99,28.57,0,1.99
"6486",6486,"Amulet of Dreams",7000,9000,2000,6.99,28.57,70,2.09
"6487",6487,"Internal Storm",2000,9000,7000,2.99,350,70,0.89
"6488",6488,"Clue/Cluedo: The Classic Mystery Game",6000,9000,3000,11.99,50,25,8.99
"6489",6489,"House of Meditation",6000,9000,3000,6.99,50,0,6.99
"6490",6490,"Zwei: The Ilvard Insurrection",5000,9000,4000,29.99,80,50,14.99
"6491",6491,"My Night Job",6000,9000,3000,3.99,50,65,1.39
"6492",6492,"The Curse of Nordic Cove",7000,9000,2000,0.99,28.57,51,0.49
"6493",6493,"Crankies Workshop: Grizzbot Assembly",5000,9000,4000,0.99,80,51,0.49
"6494",6494,"BattleStar Mazay",3000,9000,6000,0.99,200,51,0.49
"6495",6495,"MAGATAMA Earrings",4000,9000,5000,6.99,125,80,1.39
"6496",6496,"Wheely",3000,9000,6000,1.99,200,50,0.99
"6497",6497,"Drizzlepath: Genie",7000,9000,2000,7.99,28.57,50,3.99
"6498",6498,"Art of Murder - Cards of Destiny",0,9000,9000,4.99,0,55,2.24
"6499",6499,"Avadon 3: The Warborn",4000,9000,5000,19.99,125,60,7.99
"6500",6500,"Super Jagua",7000,9000,2000,0.99,28.57,51,0.49
"6501",6501,"Let's be architects",4000,9000,5000,0.99,125,51,0.49
"6502",6502,"Gravity Quest",7000,9000,2000,2.99,28.57,70,0.89
"6503",6503,"Wrestling Revolution 3D",4000,9000,5000,9.99,125,35,8.99
"6504",6504,"Unclaimed World",6000,9000,3000,18.99,50,80,3.79
"6505",6505,"Tiles",6000,9000,3000,3.99,50,50,1.99
"6506",6506,"Hitori",4000,9000,5000,0.99,125,51,0.49
"6507",6507,"Poly Towns",2000,9000,7000,4.99,350,33,3.34
"6508",6508,"Fleet Defender: The F-14 Tomcat Simulation",5000,9000,4000,6.99,80,75,1.74
"6509",6509,"Santa Rockstar",6000,9000,3000,6.99,50,0,6.99
"6510",6510,"IsoBoom",4000,9000,5000,0.99,125,0,0.99
"6511",6511,"The Invisible Hours",4000,9000,5000,29.99,125,60,11.99
"6512",6512,"Champions of Anteria",6000,9000,3000,29.99,50,75,7.49
"6513",6513,"Ice Cream Surfer",7000,9000,2000,2.99,28.57,0,2.99
"6514",6514,"Zomby Soldier",6000,9000,3000,0.99,50,51,0.49
"6515",6515,"The Madness of Little Emma",6000,9000,3000,8.99,50,80,1.79
"6516",6516,"Cute Hedgehog",6000,9000,3000,3.99,50,87,0.49
"6517",6517,"Fruit Sudoku",7000,9000,2000,0.99,28.57,51,0.49
"6518",6518,"Bighead Runner",2000,9000,7000,0.99,350,51,0.49
"6519",6519,"Robot Exploration Squad",7000,9000,2000,2.99,28.57,67,0.98
"6520",6520,"My Pet Hotel 2",2000,9000,7000,14.99,350,70,2.99
"6521",6521,"Iris.Fall",0,8000,8000,14.99,0,20,11.99
"6522",6522,"Fading Visage",2000,8000,6000,4.99,300,75,1.24
"6523",6523,"Five Rooms",2000,8000,6000,4.99,300,90,0.49
"6524",6524,"Call of Cthulhu: Shadow of the Comet",5000,8000,3000,5.99,60,75,1.49
"6525",6525,"Disney•Pixar WALL-E",6000,8000,2000,19.99,33.33,70,5.99
"6526",6526,"On Board 4 PC",6000,8000,2000,0.9,33.33,46,0.49
"6527",6527,"Swords and Sandals 5 Redux: Maximus Edition",2000,8000,6000,6.99,300,50,3.49
"6528",6528,"The Race for the White House",5000,8000,3000,14.99,60,50,7.49
"6529",6529,"HellSign",0,8000,8000,14.99,0,0,14.99
"6530",6530,"Trek: Travel Around the World",0,8000,8000,8.99,0,10,8.09
"6531",6531,"Best Time Kill",5000,8000,3000,0.99,60,51,0.49
"6532",6532,"Asyula 方舟之链",6000,8000,2000,1.99,33.33,60,0.79
"6533",6533,"Demon robot runner",2000,8000,6000,0.99,300,51,0.49
"6534",6534,"Drive//Shaft",6000,8000,2000,0.99,33.33,25,0.74
"6535",6535,"SPATIAL SOUND CARD",3000,8000,5000,9.99,166.67,25,7.49
"6536",6536,"Goldmine",3000,8000,5000,0.99,166.67,51,0.49
"6537",6537,"Fantasy Strike",4000,8000,4000,19.99,100,50,9.99
"6538",6538,"21 Days",6000,8000,2000,1.99,33.33,0,1.99
"6539",6539,"Apocalypse zombie Race",6000,8000,2000,0.99,33.33,51,0.49
"6540",6540,"Roomscale Coaster",3000,8000,5000,3.99,166.67,55,1.79
"6541",6541,"Bunny Mania 2",5000,8000,3000,4.99,60,90,0.49
"6542",6542,"Grape Jelly",6000,8000,2000,0.99,33.33,51,0.49
"6543",6543,"Robo's World: The Zarnok Fortress",6000,8000,2000,9.99,33.33,75,2.49
"6544",6544,"Lock's Quest",3000,8000,5000,14.99,166.67,50,7.49
"6545",6545,"Massive multiplayer war shooter",0,8000,8000,4.99,0,15,4.24
"6546",6546,"Detached",6000,8000,2000,24.99,33.33,75,6.24
"6547",6547,"PUTIN 20!8",6000,8000,2000,1.99,33.33,75,0.49
"6548",6548,"Sniper Squad Mission",4000,8000,4000,3.99,100,60,1.99
"6549",6549,"Silent Tweets",1000,8000,7000,1.99,700,75,0.49
"6550",6550,"Neo ATLAS 1469",5000,8000,3000,29.99,60,50,14.99
"6551",6551,"SurvivalZ Battlegrounds",6000,8000,2000,0.99,33.33,51,0.49
"6552",6552,"You're Fired",4000,8000,4000,4.99,100,90,0.49
"6553",6553,"Road Scars: Origins",2000,8000,6000,0.99,300,51,0.49
"6554",6554,"Deadstep",3000,8000,5000,4.99,166.67,0,4.99
"6555",6555,"The Incredible Baron",6000,8000,2000,4.99,33.33,80,0.99
"6556",6556,"Rage Quest: The Worst Game",1000,8000,7000,2.99,700,67,0.98
"6557",6557,"Dungeon Quest",0,8000,8000,0.99,0,51,0.49
"6558",6558,"The Mummy Demastered",6000,8000,2000,19.99,33.33,30,13.99
"6559",6559,"Robinson: The Journey",4000,8000,4000,29.99,100,75,7.49
"6560",6560,"Blades of the Righteous",5000,8000,3000,2.99,60,75,0.74
"6561",6561,"Indiana Jones and the Emperor's Tomb",0,8000,8000,5.99,0,40,3.59
"6562",6562,"The Endless Journey",5000,8000,3000,9.99,60,20,7.99
"6563",6563,"TOKYO WARFARE",4000,8000,4000,14.99,100,80,2.99
"6564",6564,"Yorkshire Gubbins",2000,8000,6000,4.99,300,40,2.99
"6565",6565,"Square Head Zombies - FPS Game",5000,8000,3000,3.99,60,87,0.51
"6566",6566,"Dead Rain - New Zombie Virus",2000,8000,6000,2.99,300,60,1.19
"6567",6567,"Tomato Jones",6000,8000,2000,1.99,33.33,50,0.99
"6568",6568,"Labirinto",1000,8000,7000,0.99,700,51,0.49
"6569",6569,"Suicideville",3000,8000,5000,0.99,166.67,51,0.49
"6570",6570,"Greeng 2D Dungeon",0,8000,8000,0.99,0,51,0.49
"6571",6571,"Heroes of Loot 2",5000,8000,3000,9.99,60,60,3.99
"6572",6572,"3D MiniGolf",5000,8000,3000,9.99,60,70,2.99
"6573",6573,"Depth of Extinction",0,8000,8000,19.99,0,25,14.99
"6574",6574,"Rugby Union Team Manager 2015",6000,8000,2000,19.99,33.33,50,9.99
"6575",6575,"Sky to Fly: Soulless Leviathan",5000,8000,3000,3.99,60,50,1.99
"6576",6576,"The Last Tower",3000,8000,5000,0.99,166.67,51,0.49
"6577",6577,"Original Journey",6000,8000,2000,11.99,33.33,60,4.79
"6578",6578,"Demonheart",4000,8000,4000,24.99,100,50,12.49
"6579",6579,"#SelfieTennis",6000,8000,2000,9.99,33.33,50,4.99
"6580",6580,"DeadTruth: The Dark Path Ahead",1000,8000,7000,8.99,700,0,8.99
"6581",6581,"Deep Dark Fantasies",6000,8000,2000,3.99,33.33,80,0.79
"6582",6582,"Only You",5000,8000,3000,2.99,60,83,0.5
"6583",6583,"Electronic Piano",5000,8000,3000,4.99,60,50,2.49
"6584",6584,"ZONE OF THE ENDERS THE 2nd RUNNER : M∀RS / アヌビス ゾーン・オブ・エンダーズ : マーズ",0,8000,8000,29.99,0,50,14.99
"6585",6585,"Remnants of Naezith",5000,8000,3000,9.99,60,50,4.99
"6586",6586,"Cublast HD",6000,8000,2000,9.99,33.33,0,9.99
"6587",6587,"Kittypocalypse",5000,8000,3000,14.99,60,55,6.74
"6588",6588,"The Secret Monster Society",5000,8000,3000,3.99,60,75,0.99
"6589",6589,"BlueberryNOVA",6000,8000,2000,2.99,33.33,20,2.39
"6590",6590,"Time Gun / 时间枪",3000,8000,5000,9.99,166.67,0,9.99
"6591",6591,"Space Fist",3000,8000,5000,15.99,166.67,0,15.99
"6592",6592,"Pandemic: The Board Game",0,8000,8000,9.99,0,60,3.99
"6593",6593,"BAE",6000,8000,2000,0.99,33.33,51,0.49
"6594",6594,"Abasralsa",3000,8000,5000,0.99,166.67,51,0.49
"6595",6595,"Behold the Kickmen",6000,8000,2000,3.99,33.33,15,3.39
"6596",6596,"Find this!",4000,8000,4000,1.99,100,75,0.49
"6597",6597,"春风 | Spring Breeze",2000,8000,6000,0.99,300,75,0.49
"6598",6598,"Battlesloths 2025: The Great Pizza Wars",5000,8000,3000,9.99,60,70,2.99
"6599",6599,"Rock, the Tree Hugger",3000,8000,5000,4.99,166.67,0,4.99
"6600",6600,"Q-YO Blaster",1000,8000,7000,3.99,700,75,0.99
"6601",6601,"Congo Merc",2000,8000,6000,4.99,300,80,0.99
"6602",6602,"Heroes Of The Offworld Arena",1000,8000,7000,4.99,700,50,2.49
"6603",6603,"Lost Sea",3000,8000,5000,14.99,166.67,90,1.49
"6604",6604,"Ancient Warfare 3",6000,8000,2000,8.99,33.33,35,5.84
"6605",6605,"Shadow Bug",6000,8000,2000,4.99,33.33,90,0.49
"6606",6606,"Long Gone Days",6000,8000,2000,14.99,33.33,20,11.99
"6607",6607,"Save Halloween: City of Witches",5000,8000,3000,4.99,60,60,1.99
"6608",6608,"A Bloody Night",6000,8000,2000,4.99,33.33,51,0.49
"6609",6609,"That Which Binds Us",0,8000,8000,8.99,0,10,8.09
"6610",6610,"The Raven Remastered",2000,8000,6000,19.99,300,50,9.99
"6611",6611,"Clergyman",6000,8000,2000,3.99,33.33,87,0.49
"6612",6612,"President Yukino",0,8000,8000,14.99,0,25,11.24
"6613",6613,"Kill to Collect",6000,8000,2000,9.99,33.33,50,4.99
"6614",6614,"PAKO 2",4000,8000,4000,9.99,100,50,4.99
"6615",6615,"Mission Runway",4000,8000,4000,9.99,100,65,3.49
"6616",6616,"CDF Ghostship",5000,8000,3000,9.99,60,90,0.99
"6617",6617,"JQ: dogs & cats",3000,8000,5000,0.99,166.67,51,0.49
"6618",6618,"Aaero",5000,8000,3000,14.99,60,75,3.74
"6619",6619,"Crudelis",5000,8000,3000,5.99,60,80,1.19
"6620",6620,"BULLET PARTY",5000,8000,3000,1.99,60,75,0.49
"6621",6621,"Abduction Bit",6000,8000,2000,0.99,33.33,51,0.49
"6622",6622,"War.io : Survival Battle Royale",0,8000,8000,0.99,0,51,0.49
"6623",6623,"The Battle for the Hut",4000,8000,4000,2.99,100,83,0.5
"6624",6624,"Trivia Vault Basketball Trivia",2000,8000,6000,1.99,300,75,0.49
"6625",6625,"Super Cloudbuilt",5000,8000,3000,19.99,60,65,6.99
"6626",6626,"Cranks and Goggles",3000,8000,5000,1.99,166.67,90,0.69
"6627",6627,"Mutants Must Die!",3000,8000,5000,3.99,166.67,80,0.79
"6628",6628,"SunAge: Battle for Elysium",6000,8000,2000,14.99,33.33,60,5.99
"6629",6629,"Game Royale 2 - The Secret of Jannis Island",6000,8000,2000,4.99,33.33,40,2.99
"6630",6630,"Pinkman",6000,8000,2000,0.99,33.33,25,0.74
"6631",6631,"Symphonic Rain",4000,8000,4000,39.99,100,40,23.99
"6632",6632,"Zen Garden",6000,8000,2000,4.99,33.33,60,1.99
"6633",6633,"Wildlife Park - Wild Creatures",4000,8000,4000,5.99,100,33,4.01
"6634",6634,"Cookies vs. Claus",5000,8000,3000,4.99,60,60,1.99
"6635",6635,"Catmaze",2000,8000,6000,9.99,300,25,7.49
"6636",6636,"Royal Casino: Video Poker",4000,8000,4000,2.99,100,84,0.49
"6637",6637,"Front Office Football Eight",5000,8000,3000,29.99,60,25,22.49
"6638",6638,"Deiland",0,8000,8000,14.99,0,35,9.74
"6639",6639,"Doodle Date",2000,8000,6000,1.99,300,35,1.29
"6640",6640,"Deranged Rabbits",6000,8000,2000,4.99,33.33,0,4.99
"6641",6641,"CMD 2048",0,8000,8000,0.99,0,45,0.54
"6642",6642,"Awakened",6000,8000,2000,2.99,33.33,0,2.99
"6643",6643,"Sweetest Monster",6000,8000,2000,5.99,33.33,25,4.49
"6644",6644,"X Rebirth VR Edition",5000,8000,3000,39.99,60,50,19.99
"6645",6645,"Cricket Captain 2018",0,8000,8000,24.99,0,50,12.49
"6646",6646,"Steven Universe: Save the Light",0,8000,8000,24.99,0,40,14.99
"6647",6647,"Siralim 3",5000,8000,3000,14.99,60,15,12.74
"6648",6648,"Dimension Hunter VR",3000,8000,5000,5.99,166.67,0,5.99
"6649",6649,"Crewsaders",6000,8000,2000,2.99,33.33,75,0.74
"6650",6650,"Merlin vs Zombies",2000,8000,6000,2.99,300,84,0.49
"6651",6651,"Disney's The Lion King",2000,8000,6000,9.99,300,50,4.99
"6652",6652,"100ft Robot Golf",5000,8000,3000,9.99,60,75,2.49
"6653",6653,"Starlight Vega",6000,8000,2000,9.99,33.33,60,3.99
"6654",6654,"Hop Step Sing! Kimamani☆Summer vacation (HQ Edition)",3000,8000,5000,6.99,166.67,25,5.24
"6655",6655,"Stellar Monarch",5000,8000,3000,19.99,60,20,15.99
"6656",6656,"18 Wheels of Steel: Haulin’",5000,8000,3000,9.99,60,65,3.49
"6657",6657,"Great eSports Manager",4000,8000,4000,9.99,100,66,3.39
"6658",6658,"AtmaSphere",2000,8000,6000,2.99,300,70,0.89
"6659",6659,"Mystica: The Ninth Society",5000,8000,3000,1.99,60,0,1.99
"6660",6660,"Potion island",0,8000,8000,1.99,0,50,0.99
"6661",6661,"RUSSIAN PEACE DUCK : TAKE MY NALOGI",4000,8000,4000,0.99,100,51,0.49
"6662",6662,"Red Comrades 3: Return of Alaska. Reloaded",5000,8000,3000,4.99,60,60,1.99
"6663",6663,"johnsgame",6000,8000,2000,0.99,33.33,51,0.49
"6664",6664,"Eon Fleet",0,8000,8000,0.99,0,51,0.49
"6665",6665,"Ria's Hook",3000,8000,5000,2.99,166.67,40,1.79
"6666",6666,"Immortal: Unchained",0,8000,8000,29.99,0,50,24.99
"6667",6667,"It`s Village",6000,8000,2000,1.99,33.33,66,0.67
"6668",6668,"MineSweep",4000,8000,4000,0.99,100,51,0.49
"6669",6669,"3D Chess",6000,8000,2000,9.99,33.33,70,2.99
"6670",6670,"Sparky's Hunt",1000,8000,7000,0.99,700,0,0.99
"6671",6671,"Infinite road",0,8000,8000,0.99,0,51,0.49
"6672",6672,"Chronicles of a Dark Lord: Tides of Fate Remastered",6000,8000,2000,4.99,33.33,80,0.99
"6673",6673,"XXZ: XXL",6000,8000,2000,5.99,33.33,75,1.49
"6674",6674,"Planet RIX-13",6000,8000,2000,2.99,33.33,70,0.89
"6675",6675,"Trivia Vault Olympics Trivia",2000,8000,6000,1.99,300,75,0.49
"6676",6676,"gRally",3000,8000,5000,3.99,166.67,0,3.99
"6677",6677,"TheLooppy",2000,8000,6000,1.99,300,75,0.49
"6678",6678,"Stellar Stars",6000,8000,2000,9.99,33.33,0,9.99
"6679",6679,"Human-powered spacecraft",1000,8000,7000,0.99,700,75,0.49
"6680",6680,"Dakar 18",0,8000,8000,49.99,0,25,37.49
"6681",6681,"killer7",0,8000,8000,19.99,0,10,17.99
"6682",6682,"Achievement Hunter: Thief",5000,8000,3000,0.99,60,51,0.49
"6683",6683,"Space Hulk: Tactics",0,8000,8000,39.99,0,25,29.99
"6684",6684,"A Little Rabbit Story",3000,8000,5000,1.99,166.67,50,0.99
"6685",6685,"Teleportals. I swear it's a nice game",1000,8000,7000,0.99,700,51,0.49
"6686",6686,"Asemblance",6000,8000,2000,7.99,33.33,75,1.99
"6687",6687,"The Golf Club 2019 featuring PGA TOUR",0,8000,8000,49.99,0,40,29.99
"6688",6688,"Skelly Selest",4000,8000,4000,4.99,100,35,2.99
"6689",6689,"Voxel Tanks",4000,8000,4000,1.99,100,60,0.49
"6690",6690,"Need to Know",0,8000,8000,14.99,0,20,11.99
"6691",6691,"KartKraft",0,8000,8000,19.99,0,10,17.99
"6692",6692,"1917 - The Alien Invasion DX",5000,8000,3000,4.99,60,80,0.99
"6693",6693,"茂伸奇谈 Monobeno",6000,8000,2000,24.99,33.33,45,13.74
"6694",6694,"Satanist",3000,8000,5000,0.99,166.67,51,0.49
"6695",6695,"Boom Island",4000,8000,4000,0.99,100,51,0.49
"6696",6696,"Legend Of Mercy 神医魔导",2000,8000,6000,9.99,300,70,2.99
"6697",6697,"SHARK",2000,8000,6000,0.99,300,51,0.49
"6698",6698,"HACK_IT",4000,8000,4000,4.99,100,80,0.99
"6699",6699,"Skyworld",6000,8000,2000,24.99,33.33,50,19.99
"6700",6700,"Crystal Towers 2 XL",6000,8000,2000,7.99,33.33,0,7.99
"6701",6701,"Ashes of Immortality",5000,8000,3000,9.99,60,90,0.99
"6702",6702,"Super Potato Bruh",0,8000,8000,3.99,0,75,0.99
"6703",6703,"Crankies Workshop: Grizzbot Assembly 2",4000,8000,4000,0.99,100,51,0.49
"6704",6704,"Crankies Workshop: Lerpbot Assembly",6000,8000,2000,0.99,33.33,51,0.49
"6705",6705,"Robo Encryption Zup",1000,8000,7000,4.99,700,70,1.49
"6706",6706,"TimeLock VR",2000,8000,6000,4.99,300,75,1.24
"6707",6707,"Alien Arena: Warriors Of Mars",5000,8000,3000,1.99,60,75,0.49
"6708",6708,"Block Shock",5000,8000,3000,0.99,60,51,0.49
"6709",6709,"VR Escape the space station",6000,8000,2000,6.99,33.33,50,3.49
"6710",6710,"The Inner World - The Last Wind Monk",4000,8000,4000,24.99,100,75,6.24
"6711",6711,"Power Hover",5000,8000,3000,4.99,60,90,0.49
"6712",6712,"Bird Game",2000,8000,6000,2.99,300,50,1.49
"6713",6713,"Wenjia",0,8000,8000,8.99,0,40,5.39
"6714",6714,"PukePuke Demon",0,8000,8000,1.99,0,75,0.49
"6715",6715,"Ninja SpeedRush",0,8000,8000,0.99,0,51,0.49
"6716",6716,"Arena Hero",3000,8000,5000,14.99,166.67,90,1.49
"6717",6717,"Grab the Bottle",6000,8000,2000,4.99,33.33,85,0.74
"6718",6718,"Ultimate Solid",6000,8000,2000,0.99,33.33,51,0.49
"6719",6719,"Bloonz Toonz",2000,8000,6000,2.99,300,75,0.74
"6720",6720,"Trivia Vault: Mixed Trivia",4000,8000,4000,4.99,100,90,0.49
"6721",6721,"Grimoire Chronicles",4000,8000,4000,3.99,100,88,0.49
"6722",6722,"众生",6000,8000,2000,14.99,33.33,0,14.99
"6723",6723,"War of Criminals",5000,8000,3000,2.99,60,65,1.39
"6724",6724,"Mayhem Intergalactic",6000,8000,2000,9.99,33.33,0,9.99
"6725",6725,"PING 1.5+",6000,8000,2000,4.99,33.33,90,0.49
"6726",6726,"Sentience: The Android's Tale",6000,8000,2000,3.99,33.33,80,0.79
"6727",6727,"Silicon Zeroes",6000,8000,2000,14.99,33.33,33,10.04
"6728",6728,"Battlevoid: Sector Siege",5000,8000,3000,9.99,60,90,0.99
"6729",6729,"Bouncing Duck Simulator",6000,8000,2000,4.99,33.33,70,1.49
"6730",6730,"Quick Draw",6000,8000,2000,9.99,33.33,50,4.99
"6731",6731,"GNOG",0,8000,8000,9.99,0,20,7.99
"6732",6732,"Stellar Interface",6000,8000,2000,12.99,33.33,75,3.24
"6733",6733,"Reach Me",3000,8000,5000,1.99,166.67,70,0.59
"6734",6734,"WAVESHAPER",5000,8000,3000,1.99,60,66,0.49
"6735",6735,"Slipstream",5000,8000,3000,9.99,60,15,8.49
"6736",6736,"Catacombs 1: Demon War",3000,8000,5000,1.99,166.67,60,0.79
"6737",6737,"Art of Murder - FBI Confidential",0,8000,8000,4.99,0,55,2.24
"6738",6738,"Zombie Camp",5000,8000,3000,1.99,60,0,1.99
"6739",6739,"Geneshift",4000,8000,4000,9.99,100,30,6.99
"6740",6740,"The Watson-Scott Test",0,8000,8000,4.99,0,20,3.99
"6741",6741,"Royal Offense",6000,8000,2000,2.99,33.33,75,0.74
"6742",6742,"Divinia Chronicles: Relics of Gan-Ti",5000,8000,3000,14.99,60,48,7.79
"6743",6743,"The Clockwork Man: The Hidden World",6000,8000,2000,9.99,33.33,75,2.49
"6744",6744,"Trivia Vault: Boxing Trivia",4000,8000,4000,1.99,100,75,0.49
"6745",6745,"Pilferer",6000,8000,2000,0.99,33.33,51,0.49
"6746",6746,"Raging Titan",6000,8000,2000,4.99,33.33,33,3.34
"6747",6747,"Girl Blonde",5000,8000,3000,1.99,60,75,0.49
"6748",6748,"PLANET ALPHA",0,8000,8000,19.99,0,40,11.99
"6749",6749,"Timber Tennis: Versus",1000,8000,7000,1.99,700,10,1.79
"6750",6750,"Holy Towers",5000,8000,3000,4.99,60,0,4.99
"6751",6751,"Ittle Dew 2",4000,8000,4000,19.99,100,50,9.99
"6752",6752,"Pick a Hero",4000,8000,4000,1.99,100,20,0.79
"6753",6753,"Cuit",4000,8000,4000,2.99,100,75,0.74
"6754",6754,"Click&Fight",4000,8000,4000,1.99,100,75,0.49
"6755",6755,"Unworthy",4000,8000,4000,14.99,100,25,11.24
"6756",6756,"9th Dawn II",5000,8000,3000,1.99,60,50,0.99
"6757",6757,"Blaster Cop",5000,8000,3000,1.99,60,75,0.49
"6758",6758,"Final Directive",3000,8000,5000,1.99,166.67,51,0.97
"6759",6759,"Safety Driving Simulator: Car",6000,8000,2000,4.99,33.33,60,1.99
"6760",6760,"Morph Girl",2000,8000,6000,3.99,300,50,1.99
"6761",6761,"Beat The Game",3000,8000,5000,9.99,166.67,50,4.99
"6762",6762,"The Minims",6000,8000,2000,9.99,33.33,0,9.99
"6763",6763,"Momonga Pinball Adventures",5000,8000,3000,5.99,60,60,2.39
"6764",6764,"Blackberry Honey",4000,8000,4000,12.99,100,20,10.39
"6765",6765,"Anime Fight in the Arena of Death",0,8000,8000,0.99,0,51,0.49
"6766",6766,"Harmless Skeleton",6000,8000,2000,3.99,33.33,87,0.49
"6767",6767,"My Little Bomb",6000,8000,2000,0.99,33.33,51,0.49
"6768",6768,"辣条杂货店:令人感动的童年回忆，经典策略模拟经营解密",5000,8000,3000,5.99,60,0,5.99
"6769",6769,"DROD: Gunthro and the Epic Blunder",5000,8000,3000,9.99,60,75,2.49
"6770",6770,"Park the car",0,8000,8000,0.99,0,51,0.49
"6771",6771,"Paperbound",6000,8000,2000,9.99,33.33,0,9.99
"6772",6772,"Tod Stein",0,8000,8000,0.99,0,51,0.49
"6773",6773,"Dragon's Lair 2: Time Warp",6000,8000,2000,9.99,33.33,50,4.99
"6774",6774,"Valcarta: Rise of the Demon",6000,8000,2000,6.99,33.33,85,1.04
"6775",6775,"Robo Miner",3000,8000,5000,2.99,166.67,30,2.09
"6776",6776,"SuperMoose",6000,8000,2000,1.99,33.33,70,0.59
"6777",6777,"Super GTR Racing",3000,8000,5000,3.99,166.67,88,0.49
"6778",6778,"Underworld Ascendant",1000,8000,7000,29.99,700,15,25.49
"6779",6779,"Freeways",4000,8000,4000,3.99,100,25,2.99
"6780",6780,"祛魅·教化（祛魅1）",1000,7000,6000,0.99,600,16,0.83
"6781",6781,"Thick Light 2",0,7000,7000,0.99,0,51,0.49
"6782",6782,"Gal*Gun 2",0,7000,7000,44.99,0,50,29.99
"6783",6783,"Ruin of the Reckless",4000,7000,3000,9.99,75,55,4.49
"6784",6784,"Woody Blox",3000,7000,4000,0.99,133.33,51,0.49
"6785",6785,"Guppy",5000,7000,2000,2.99,40,50,1.49
"6786",6786,"Writers",2000,7000,5000,3.99,250,80,0.79
"6787",6787,"Debtor",4000,7000,3000,1.99,75,75,0.49
"6788",6788,"Music Inside: A VR Rhythm Game",2000,7000,5000,9.99,250,0,9.99
"6789",6789,"CRASHBOT",3000,7000,4000,2.99,133.33,83,0.5
"6790",6790,"THE LAST BLADE 2",4000,7000,3000,9.99,75,50,4.99
"6791",6791,"Intrude",4000,7000,3000,3.99,75,50,1.99
"6792",6792,"Prey: Typhon Hunter",0,7000,7000,39.99,0,50,19.99
"6793",6793,"The Art Of Knuckle Sandwich",3000,7000,4000,8.99,133.33,90,0.89
"6794",6794,"Cyberline Racing",5000,7000,2000,0.99,40,51,0.49
"6795",6795,"Margot's Word Brain",0,7000,7000,2.99,0,70,0.89
"6796",6796,"Little hidden city",2000,7000,5000,1.99,250,75,0.49
"6797",6797,"Robert Rodriguez’s THE LIMIT: An Immersive Cinema Experience",0,7000,7000,4.99,0,0,4.99
"6798",6798,"Neptune: Arena FPS",2000,7000,5000,4.99,250,80,0.99
"6799",6799,"Hanse - The Hanseatic League",4000,7000,3000,19.99,75,50,9.99
"6800",6800,"Trash Squad",1000,7000,6000,4.99,600,90,0.49
"6801",6801,"Glasswinged Ascension",5000,7000,2000,0.99,40,83,0.49
"6802",6802,"C2H6O",5000,7000,2000,1.99,40,75,0.49
"6803",6803,"Chronoclysm",5000,7000,2000,4.99,40,0,4.99
"6804",6804,"The Tenth Line",5000,7000,2000,9.99,40,66,3.39
"6805",6805,"Defense the Farm",3000,7000,4000,0.99,133.33,51,0.49
"6806",6806,"ROKH",4000,7000,3000,19.99,75,0,9.99
"6807",6807,"One Dog Story",3000,7000,4000,4.99,133.33,50,2.49
"6808",6808,"Orblitz",2000,7000,5000,0.99,250,0,0.99
"6809",6809,"Mana Spark",0,7000,7000,9.99,0,15,8.49
"6810",6810,"The Initiate",3000,7000,4000,12.99,133.33,70,4.49
"6811",6811,"Super Arcade Football",4000,7000,3000,9.99,75,50,4.99
"6812",6812,"Bitcoin Trader",2000,7000,5000,2.99,250,90,0.49
"6813",6813,"HeartZ: Co-Hope Puzzles",5000,7000,2000,9.99,40,75,2.49
"6814",6814,"Hunted: One Step Too Far",5000,7000,2000,4.99,40,80,0.99
"6815",6815,"Silver Bullet: Prometheus",5000,7000,2000,4.99,40,90,0.49
"6816",6816,"DeFaster",0,7000,7000,0.99,0,51,0.49
"6817",6817,"Kingdom Tales",5000,7000,2000,2.99,40,70,0.89
"6818",6818,"Next",4000,7000,3000,0.99,75,51,0.49
"6819",6819,"Celestial Creator",1000,7000,6000,0.99,600,50,0.99
"6820",6820,"Leaflet Love Story",0,7000,7000,2.99,0,40,1.79
"6821",6821,"Super Bunny Man",4000,7000,3000,13.99,75,0,12.99
"6822",6822,"Papich - The Game Ep.1",4000,7000,3000,1.99,75,75,0.49
"6823",6823,"Demon's Crystals",4000,7000,3000,4.99,75,60,1.99
"6824",6824,"A Princess' Tale",5000,7000,2000,4.99,40,90,0.49
"6825",6825,"Gopnik Simulator",3000,7000,4000,0.99,133.33,51,0.49
"6826",6826,"Valthirian Arc: Hero School Story",0,7000,7000,14.99,0,20,11.99
"6827",6827,"D.N.Age",3000,7000,4000,4.99,133.33,60,1.99
"6828",6828,"CYBER JOLT (VR)",5000,7000,2000,0.99,40,37,0.62
"6829",6829,"V ARRR",4000,7000,3000,9.99,75,90,0.99
"6830",6830,"Sweet Girl Adventure 2",0,7000,7000,0.99,0,40,0.59
"6831",6831,"The Cursed Love",0,7000,7000,1.99,0,65,1.39
"6832",6832,"Sumeru",5000,7000,2000,6.99,40,60,2.79
"6833",6833,"ZoneDriver",5000,7000,2000,0.99,40,51,0.49
"6834",6834,"QLORB",5000,7000,2000,0.99,40,51,0.49
"6835",6835,"MOMO.EXE",0,7000,7000,1.99,0,55,0.89
"6836",6836,"Glory of the Self-Styled Diehard girl",2000,7000,5000,3.99,250,25,1.49
"6837",6837,"Insane Decay of Mind: The Labyrinth",4000,7000,3000,2.99,75,80,0.59
"6838",6838,"Let's Sing 2016",3000,7000,4000,24.99,133.33,66,8.49
"6839",6839,"Plant This",5000,7000,2000,0.99,40,75,0.49
"6840",6840,"Tank Warfare: Tunisia 1943",5000,7000,2000,39.99,40,80,7.99
"6841",6841,"THE QUIET MAN",0,7000,7000,14.99,0,10,13.49
"6842",6842,"Grisaia Phantom Trigger Vol.3",3000,7000,4000,14.99,133.33,35,9.74
"6843",6843,"Sky Hawk",2000,7000,5000,2.99,250,75,0.99
"6844",6844,"Pulse",3000,7000,4000,7.99,133.33,85,1.59
"6845",6845,"SOK MAX",2000,7000,5000,1.99,250,75,0.49
"6846",6846,"SUMETRICK",3000,7000,4000,0.99,133.33,51,0.49
"6847",6847,"Space man adventure dash",3000,7000,4000,0.99,133.33,51,0.49
"6848",6848,"Achievement Lurker: Respectable Accomplishment",2000,7000,5000,1.99,250,60,0.79
"6849",6849,"Cut The Ex-Girlfriends",1000,7000,6000,0.99,600,51,0.49
"6850",6850,"Pavilion",3000,7000,4000,9.99,133.33,50,4.99
"6851",6851,"Harts",5000,7000,2000,1.99,40,60,0.79
"6852",6852,"Alien Hallway 2",2000,7000,5000,9.99,250,65,3.49
"6853",6853,"東方幕華祭 TouHou Makuka Sai ~ Fantastic Danmaku Festival",0,7000,7000,8.99,0,20,7.19
"6854",6854,"The Duller",3000,7000,4000,0.99,133.33,51,0.49
"6855",6855,"Mumps",4000,7000,3000,0.99,75,51,0.49
"6856",6856,"Death Space",0,7000,7000,0.99,0,40,0.59
"6857",6857,"Galimulator",2000,7000,5000,4.99,250,40,2.99
"6858",6858,"EARTH DEFENSE FORCE 4.1 WINGDIVER THE SHOOTER",4000,7000,3000,19.99,75,50,9.99
"6859",6859,"Gun Brothers",5000,7000,2000,9.99,40,90,0.99
"6860",6860,"Leisure Suit Larry 6 - Shape Up Or Slip Out",4000,7000,3000,4.99,75,50,2.49
"6861",6861,"Achievement Hunter: Scars",4000,7000,3000,0.99,75,51,0.49
"6862",6862,"Zoo Tycoon: Ultimate Animal Collection",0,7000,7000,19.99,0,25,14.99
"6863",6863,"OutSplit",5000,7000,2000,0.99,40,51,0.49
"6864",6864,"Aiball: Drunks",4000,7000,3000,0.99,75,51,0.49
"6865",6865,"Total Extreme Wrestling 2013",3000,7000,4000,19.99,133.33,75,4.99
"6866",6866,"DYING: Reborn",4000,7000,3000,12.99,75,80,2.59
"6867",6867,"Owen to have fun!",3000,7000,4000,1.99,133.33,75,0.49
"6868",6868,"Fortissimo FA INTL Ver",0,7000,7000,9.99,0,60,1.19
"6869",6869,"Police Patrol",3000,7000,4000,0.99,133.33,51,0.49
"6870",6870,"建筑大冒险 Architectural Adventure",0,7000,7000,0.99,0,0,0.99
"6871",6871,"TEVA",1000,7000,6000,0.99,600,51,0.49
"6872",6872,"Little Adventurer II",5000,7000,2000,0.99,40,51,0.49
"6873",6873,"So Many Me",5000,7000,2000,14.99,40,80,2.99
"6874",6874,"Companion",3000,7000,4000,9.99,133.33,50,4.99
"6875",6875,"Racket Fury: Table Tennis VR",4000,7000,3000,9.99,75,40,5.99
"6876",6876,"Natural Locomotion",2000,7000,5000,9.99,250,20,7.99
"6877",6877,"Bitcoin Trading Master: Simulator",3000,7000,4000,4.99,133.33,35,1.49
"6878",6878,"Bunny Hop",2000,7000,5000,0.99,250,51,0.49
"6879",6879,"JJBoom",0,7000,7000,9.99,0,90,0.99
"6880",6880,"MILF",3000,7000,4000,0.99,133.33,45,0.54
"6881",6881,"The Momo Game",0,7000,7000,1.99,0,50,0.99
"6882",6882,"River City Melee : Battle Royal Special",3000,7000,4000,19.99,133.33,80,3.99
"6883",6883,"Russian Prisoner VS Nazi Zombies",2000,7000,5000,0.99,250,51,0.49
"6884",6884,"Tragedy of Prince Rupert",5000,7000,2000,4.99,40,80,0.99
"6885",6885,"Regular Human Basketball",0,7000,7000,4.99,0,20,3.99
"6886",6886,"Gay World",4000,7000,3000,0.99,75,51,0.49
"6887",6887,"Wacky Wheels HD",2000,7000,5000,9.99,250,70,2.99
"6888",6888,"Starlight Inception",5000,7000,2000,9.99,40,75,2.49
"6889",6889,"The Dragons' Twilight",4000,7000,3000,3.99,75,50,1.99
"6890",6890,"Mhakna Gramura and Fairy Bell",2000,7000,5000,4.99,250,20,3.99
"6891",6891,"Rainbow Snake",5000,7000,2000,0.99,40,87,0.49
"6892",6892,"Don Bradman Cricket 17",5000,7000,2000,49.99,40,25,37.49
"6893",6893,"Goat Life",3000,7000,4000,3.99,133.33,87,0.49
"6894",6894,"Leisure Suit Larry 1 - In the Land of the Lounge Lizards",4000,7000,3000,3.99,75,50,1.99
"6895",6895,"DevWill",5000,7000,2000,0.99,40,51,0.49
"6896",6896,"TacoFace",1000,7000,6000,0.99,600,0,0.99
"6897",6897,"Tower Hunter: Erza's Trial",0,7000,7000,15.99,0,20,12.79
"6898",6898,"Age of Castles: Warlords",5000,7000,2000,1.99,40,75,0.49
"6899",6899,"The Last Warlock",5000,7000,2000,5.99,40,50,2.99
"6900",6900,"Sengoku Jidai: Shadow of the Shogun",4000,7000,3000,29.99,75,65,10.49
"6901",6901,"NALOGI 2",1000,7000,6000,1.99,600,75,0.49
"6902",6902,"Attentat 1942",4000,7000,3000,10.99,75,50,5.49
"6903",6903,"Healer's Quest",4000,7000,3000,14.99,75,35,9.74
"6904",6904,"Wildlife Creative Studio",5000,7000,2000,6.99,40,50,3.49
"6905",6905,"Geared",2000,7000,5000,2.99,250,0,2.99
"6906",6906,"Hope in Hell",5000,7000,2000,2.99,40,0,2.99
"6907",6907,"Zen Chess: Mate in One",3000,7000,4000,0.99,133.33,40,0.59
"6908",6908,"NOSTALGIC TRAIN",4000,7000,3000,18.99,75,0,18.99
"6909",6909,"Dead Acres",4000,7000,3000,4.99,75,40,2.99
"6910",6910,"Nusakana",3000,7000,4000,8.99,133.33,75,2.24
"6911",6911,"Trooper 1",5000,7000,2000,2.99,40,50,1.49
"6912",6912,"Default Dan",4000,7000,3000,5.99,75,0,5.99
"6913",6913,"Dead",3000,7000,4000,4.99,133.33,50,2.49
"6914",6914,"Arvale",5000,7000,2000,7.99,40,90,0.79
"6915",6915,"Wo Yao Da 我要大",5000,7000,2000,2.99,40,50,1.49
"6916",6916,"Tail Drift",5000,7000,2000,9.99,40,0,9.99
"6917",6917,"Katamari Damacy REROLL",0,7000,7000,29.99,0,0,29.99
"6918",6918,"Slay.one",2000,7000,5000,9.99,250,30,6.99
"6919",6919,"PubgTrainingCamp",4000,7000,3000,2.99,75,0,2.99
"6920",6920,"Lost In Space",5000,7000,2000,0.99,40,51,0.49
"6921",6921,"Gamer Career Tycoon",3000,7000,4000,8.99,133.33,90,0.89
"6922",6922,"Kingdom Defense",5000,7000,2000,0.99,40,51,0.49
"6923",6923,"Attack of the Earthlings",5000,7000,2000,19.99,40,30,13.99
"6924",6924,"Trivia Vault: Soccer Trivia",1000,7000,6000,1.99,600,75,0.49
"6925",6925,"The Horus Heresy: Battle of Tallarn - Iron Edition",4000,7000,3000,9.99,75,90,0.99
"6926",6926,"Capcom Beat 'Em Up Bundle / カプコン ベルトアクション コレクション",0,7000,7000,19.99,0,0,19.99
"6927",6927,"inVokeR",2000,7000,5000,14.99,250,90,1.49
"6928",6928,"EVIL POSSESSION",4000,7000,3000,0.99,75,51,0.49
"6929",6929,"Apocryph: an old-school shooter",2000,7000,5000,14.99,250,50,7.49
"6930",6930,"Don't Sink",5000,7000,2000,9.99,40,50,4.99
"6931",6931,"Age of Rivals",4000,7000,3000,9.99,75,50,4.99
"6932",6932,"Captive",1000,7000,6000,1.99,600,70,0.67
"6933",6933,"Bus Tycoon ND (Night and Day)",5000,7000,2000,2.99,40,65,1.04
"6934",6934,"DEEP SPACE | Space-Platformer",2000,7000,5000,4.99,250,65,1.74
"6935",6935,"openCanvas 7",5000,7000,2000,59.99,40,20,47.99
"6936",6936,"Soup: the Game",5000,7000,2000,1.99,40,0,1.99
"6937",6937,"Lily's Day Off",5000,7000,2000,2.99,40,67,0.98
"6938",6938,"Monsterland",3000,7000,4000,0.99,133.33,0,0.99
"6939",6939,"Super Animal Royale",0,7000,7000,12.99,0,10,11.69
"6940",6940,"Don't Bite Me Bro! +",0,7000,7000,0.99,0,0,0.99
"6941",6941,"Treasure Hunter Simulator",0,7000,7000,16.99,0,15,14.44
"6942",6942,"Lucy Got Problems",0,7000,7000,7.99,0,15,6.79
"6943",6943,"Teal",4000,7000,3000,3.99,75,75,0.99
"6944",6944,"Thing-in-Itself",5000,7000,2000,2.49,40,80,0.49
"6945",6945,"Ashes",5000,7000,2000,0.99,40,51,0.49
"6946",6946,"Rex: Another Island",3000,7000,4000,2.99,133.33,50,1.49
"6947",6947,"Indian Mutiny: Little Sepoy",3000,7000,4000,3.99,133.33,75,1.49
"6948",6948,"Dragon Perception",5000,7000,2000,0.99,40,51,0.49
"6949",6949,"Legends of Iskaria: Days of Thieves",1000,7000,6000,2.99,600,75,0.74
"6950",6950,"Hello Charlotte EP3: Childhood's End",5000,7000,2000,2.99,40,30,2.09
"6951",6951,"INVERSUS Deluxe",5000,7000,2000,14.99,40,67,4.94
"6952",6952,"Tiny Mage",4000,7000,3000,0.99,75,83,0.49
"6953",6953,"One Piece: Unlimited World Red - Deluxe Edition",5000,7000,2000,39.99,40,75,9.99
"6954",6954,"Wormster Dash",0,7000,7000,1.99,0,30,1.39
"6955",6955,"quadrantica",2000,7000,5000,1.99,250,50,0.99
"6956",6956,"Anime Dress Up",0,7000,7000,0.99,0,51,0.49
"6957",6957,"Loot Box Quest",5000,7000,2000,0.99,40,30,0.69
"6958",6958,"CHAOS CODE -NEW SIGN OF CATASTROPHE-",5000,7000,2000,19.99,40,75,4.99
"6959",6959,"Project Glitch",2000,7000,5000,0.99,250,0,0.99
"6960",6960,"JQ: countries",2000,7000,5000,0.99,250,51,0.49
"6961",6961,"Gevaudan",5000,7000,2000,2.99,40,50,1.49
"6962",6962,"SWORDY",4000,7000,3000,14.99,75,0,14.99
"6963",6963,"G2 Fighter",0,7000,7000,15.99,0,20,12.79
"6964",6964,"Club of fighters",5000,7000,2000,1.99,40,50,0.99
"6965",6965,"OF MICE AND SAND -REVISED-",5000,7000,2000,9.99,40,20,7.99
"6966",6966,"Trivia Vault: Celebrity Trivia",3000,7000,4000,1.99,133.33,75,0.49
"6967",6967,"Close Me",5000,7000,2000,0.99,40,20,0.79
"6968",6968,"Shadows on the Vatican Act II: Wrath",5000,7000,2000,6.99,40,70,2.09
"6969",6969,"Rugby League Team Manager 2015",5000,7000,2000,19.99,40,50,9.99
"6970",6970,"Craft and Dungeon",4000,7000,3000,0.99,75,35,0.64
"6971",6971,"Front Office Football Seven",5000,7000,2000,14.99,40,30,13.29
"6972",6972,"Stickman Jetpack",5000,7000,2000,0.99,40,51,0.49
"6973",6973,"Ian's Eyes",3000,7000,4000,9.99,133.33,90,0.99
"6974",6974,"There Is A Genie In My Szechuan Sauce",4000,7000,3000,1.99,75,60,0.79
"6975",6975,"Conductor",5000,7000,2000,9.99,40,50,4.99
"6976",6976,"PooSky",5000,7000,2000,1.99,40,75,0.49
"6977",6977,"Deep Sorrow",4000,7000,3000,3.99,75,50,1.99
"6978",6978,"Urban War Defense",3000,7000,4000,5.99,133.33,75,1.49
"6979",6979,"Time To Walk Alone",4000,7000,3000,0.99,75,51,0.49
"6980",6980,"Barter Empire",5000,7000,2000,4.99,40,0,4.99
"6981",6981,"Crankies Workshop: Whirlbot Assembly",4000,7000,3000,0.99,75,51,0.49
"6982",6982,"Achievement Hunter: Alien",5000,7000,2000,0.99,40,51,0.49
"6983",6983,"Farm Frenzy Collection",5000,7000,2000,19.99,40,60,7.99
"6984",6984,"Achievement Hunter: Zombie",5000,7000,2000,0.99,40,51,0.49
"6985",6985,"Brick Breaker Ultimate",5000,7000,2000,0.99,40,51,0.49
"6986",6986,"Trivia Vault: Art Trivia",2000,7000,5000,1.99,250,75,0.49
"6987",6987,"Gladiabots",0,7000,7000,14.99,0,10,13.49
"6988",6988,"ArcBall",5000,7000,2000,0.99,40,51,0.49
"6989",6989,"My Holiday",0,7000,7000,4.99,0,15,4.24
"6990",6990,"The Blackout Club",0,7000,7000,19.99,0,10,17.99
"6991",6991,"Immortal Planet",5000,7000,2000,14.99,40,60,5.99
"6992",6992,"Darkestville Castle",4000,7000,3000,14.99,75,50,7.49
"6993",6993,"Starr Mazer: DSP",5000,7000,2000,9.99,40,30,6.99
"6994",6994,"Shadows of Adam",3000,7000,4000,14.99,133.33,50,7.49
"6995",6995,"Angels That Kill",5000,7000,2000,2.99,40,50,1.49
"6996",6996,"U-BOOT 1945",0,7000,7000,1.99,0,75,0.49
"6997",6997,"First Winter",1000,7000,6000,3.99,600,50,1.99
"6998",6998,"News Tycoon",5000,7000,2000,6.99,40,60,2.79
"6999",6999,"Armored Kitten",3000,7000,4000,2.99,133.33,25,2.24
"7000",7000,"Prisoner",4000,7000,3000,2.99,75,75,0.74
"7001",7001,"DiscStorm",5000,7000,2000,11.99,40,60,4.79
"7002",7002,"Shotgun Legend",4000,7000,3000,4.99,75,80,0.49
"7003",7003,"Z-Exemplar",5000,7000,2000,1.99,40,75,1.24
"7004",7004,"Colt Express",4000,7000,3000,6.99,75,57,3
"7005",7005,"Club Manager 2017",4000,7000,3000,29.99,75,50,14.99
"7006",7006,"Warlords Awakening",0,7000,7000,11.99,0,25,8.99
"7007",7007,"Scary Maze",3000,7000,4000,0.99,133.33,51,0.49
"7008",7008,"Darkness and Flame: Born of Fire",2000,7000,5000,6.99,250,60,2.79
"7009",7009,"Trivia Vault: Movie Trivia",0,7000,7000,1.99,0,75,0.49
"7010",7010,"Box Maze Extreme",5000,7000,2000,0.99,40,51,0.49
"7011",7011,"Ultimate Select Hero / 究极勇者的选择传说",2000,7000,5000,1.99,250,60,0.79
"7012",7012,"樱之杜†净梦者 完全版 Sakura no Mori † Dreamers",5000,7000,2000,17.99,40,45,9.89
"7013",7013,"EARTHLOCK",3000,7000,4000,29.99,133.33,52,14.39
"7014",7014,"Indie Game Sim",4000,7000,3000,7.99,75,75,1.99
"7015",7015,"Klang",5000,7000,2000,14.99,40,75,3.74
"7016",7016,"SOK MIN",5000,7000,2000,1.99,40,75,0.49
"7017",7017,"Forgotten Realm RPG",2000,7000,5000,4.99,250,75,1.24
"7018",7018,"Trick Shot",5000,7000,2000,1.99,40,0,1.99
"7019",7019,"Super Blackjack Battle 2 Turbo Edition - The Card Warriors",4000,7000,3000,11.99,75,50,5.99
"7020",7020,"Mermaid Land",0,7000,7000,3.99,0,75,0.99
"7021",7021,"Card Quest",4000,7000,3000,9.99,75,50,4.99
"7022",7022,"GALAXY 3D SPACE DEFENDER",3000,7000,4000,0.99,133.33,51,0.49
"7023",7023,"Dehumanized",0,7000,7000,1.99,0,50,0.99
"7024",7024,"Neon Warp",4000,7000,3000,1.99,75,75,0.49
"7025",7025,"Zeus vs Monsters - Math Game for kids",3000,7000,4000,5.99,133.33,0,5.99
"7026",7026,"Math Speed Challenge",2000,7000,5000,0.99,250,51,0.49
"7027",7027,"Speedway Challenge League",5000,7000,2000,2.99,40,0,2.99
"7028",7028,"PRINCIPIA: Master of Science",5000,7000,2000,9.99,40,40,5.99
"7029",7029,"LIGHT",1000,7000,6000,0.99,600,75,0.49
"7030",7030,"Cold Space",3000,7000,4000,5.99,133.33,0,5.99
"7031",7031,"War Tech Fighters",5000,7000,2000,19.99,40,50,7.49
"7032",7032,"Tametsi",1000,7000,6000,2.99,600,75,0.74
"7033",7033,"WaveLand",3000,7000,4000,9.99,133.33,75,2.49
"7034",7034,"Dragon's Dungeon: Awakening",5000,7000,2000,9.99,40,90,0.99
"7035",7035,"Wayhaven Chronicles: Book One",4000,7000,3000,4.99,75,40,2.99
"7036",7036,"Jailbreak Russia",0,7000,7000,0.99,0,51,0.49
"7037",7037,"Fairy Escape",2000,7000,5000,1.99,250,75,0.49
"7038",7038,"Airbo",2000,7000,5000,0.99,250,51,0.49
"7039",7039,"Somewhere on Zibylon",5000,7000,2000,9.99,40,75,2.49
"7040",7040,"Clockwork",5000,7000,2000,2.99,40,90,0.49
"7041",7041,"Fated Souls",4000,7000,3000,9.99,75,90,0.99
"7042",7042,"Real Farm",5000,7000,2000,19.99,40,90,1.99
"7043",7043,"Escape Artist: The Trial",5000,7000,2000,0.99,40,51,0.49
"7044",7044,"Zombie Clicker Defense",5000,7000,2000,1.99,40,75,0.49
"7045",7045,"The Preposterous Awesomeness of Everything",5000,7000,2000,6.99,40,80,1.39
"7046",7046,"Outbreak: The New Nightmare",4000,7000,3000,12.99,75,70,3.89
"7047",7047,"Squirm",2000,7000,5000,1.99,250,70,0.59
"7048",7048,"Tower!3D",3000,7000,4000,29.99,133.33,50,14.99
"7049",7049,"Witches, Heroes and Magic",3000,7000,4000,7.99,133.33,90,1.49
"7050",7050,"BLADENET",5000,7000,2000,6.99,40,33,4.68
"7051",7051,"TITAN SLAYER",5000,7000,2000,12.99,40,50,6.49
"7052",7052,"Melting World Online",1000,7000,6000,9.99,600,60,3.99
"7053",7053,"Omegaland",1000,7000,6000,2.99,600,50,1.49
"7054",7054,"Colorzzle",1000,7000,6000,1.99,600,25,1.49
"7055",7055,"Night Trap - 25th Anniversary Edition",3000,7000,4000,14.99,133.33,66,5.09
"7056",7056,"Vanilla Bagel: The Roguelike",4000,7000,3000,12.99,75,77,2.98
"7057",7057,"Aeon",5000,7000,2000,19.99,40,70,5.99
"7058",7058,"Dispersio",3000,7000,4000,0.99,133.33,51,0.49
"7059",7059,"Dupio",3000,7000,4000,0.99,133.33,51,0.49
"7060",7060,"Winner Winner Chicken Dinner!",3000,7000,4000,0.99,133.33,51,0.49
"7061",7061,"Hard Rock Zombie Truck",3000,7000,4000,3.99,133.33,87,0.51
"7062",7062,"Dragon Fantasy: The Black Tome of Ice",5000,7000,2000,9.99,40,90,0.99
"7063",7063,"Skedaddle",5000,7000,2000,3.99,40,0,2.99
"7064",7064,"Snail Racer EXTREME",0,7000,7000,0.99,0,51,0.49
"7065",7065,"ASRECorp",1000,7000,6000,0.99,600,0,0.99
"7066",7066,"Myst III: Exile",0,7000,7000,14.99,0,40,8.99
"7067",7067,"Aviation Hurricane Storm",2000,7000,5000,0.99,250,51,0.49
"7068",7068,"Kynseed",0,7000,7000,9.99,0,0,9.99
"7069",7069,"Tiny Town VR",2000,7000,5000,14.99,250,40,8.99
"7070",7070,"Circle pong",5000,7000,2000,0.99,40,51,0.49
"7071",7071,"Trivia Vault Baseball Trivia",2000,7000,5000,1.99,250,75,0.49
"7072",7072,"Mystical",1000,7000,6000,4.99,600,50,2.49
"7073",7073,"The Crow's Eye",3000,7000,4000,4.99,133.33,80,0.99
"7074",7074,"Quanect",5000,7000,2000,1.99,40,75,0.74
"7075",7075,"Transparent Black",4000,7000,3000,0.99,75,45,0.54
"7076",7076,"PRE:ONE",3000,7000,4000,4.99,133.33,40,2.99
"7077",7077,"Z55Z",1000,7000,6000,1.99,600,75,0.49
"7078",7078,"Making History: The Second World War",3000,7000,4000,29.99,133.33,50,14.99
"7079",7079,"Gaygarin In deep as's'pace",0,7000,7000,0.99,0,51,0.49
"7080",7080,"Z Runaway",3000,7000,4000,1.99,133.33,75,0.49
"7081",7081,"Muv-Luv Alternative",4000,7000,3000,39.99,75,40,23.99
"7082",7082,"Monsters' Den: Book of Dread",4000,7000,3000,4.99,75,75,1.24
"7083",7083,"I wanna be The Cat",5000,7000,2000,6.99,40,20,5.59
"7084",7084,"OldMaidGirl",3000,7000,4000,1.99,133.33,20,1.59
"7085",7085,"ShellBlast: Legacy Edition",1000,6000,5000,3.99,500,75,0.99
"7086",7086,"Once in Yaissor 2",1000,6000,5000,0.99,500,45,0.54
"7087",7087,"My Car",4000,6000,2000,0.99,50,51,0.49
"7088",7088,"Cat doesn't like banana",0,6000,6000,0.99,0,51,0.49
"7089",7089,"Beachhead 2000",1000,6000,5000,2.99,500,0,2.99
"7090",7090,"Outrunner 2",4000,6000,2000,0.99,50,51,0.49
"7091",7091,"Solar Settlers",3000,6000,3000,9.99,100,33,6.69
"7092",7092,"Mystika 3 : Awakening of the dragons",2000,6000,4000,4.99,200,60,1.99
"7093",7093,"Sky Noon",4000,6000,2000,14.99,50,50,7.49
"7094",7094,"Anonymous ME",4000,6000,2000,6.99,50,0,6.99
"7095",7095,"The Warrior Of Treasures 2: Skull Hunter",0,6000,6000,0.99,0,51,0.49
"7096",7096,"ZHUST - THE ILLUSION SOUL",4000,6000,2000,4.99,50,80,0.99
"7097",7097,"Dig Dog",1000,6000,5000,2.99,500,33,2
"7098",7098,"Hostage: Rescue Mission",1000,6000,5000,4.99,500,50,2.49
"7099",7099,"Hunting Unlimited 2011",2000,6000,4000,9.99,200,65,3.49
"7100",7100,"Flurius",0,6000,6000,0.99,0,51,0.49
"7101",7101,"Renoir",4000,6000,2000,9.99,50,80,1.99
"7102",7102,"My zero trip",3000,6000,3000,0.99,100,51,0.49
"7103",7103,"Shogo: Mobile Armor Division",3000,6000,3000,9.99,100,66,3.39
"7104",7104,"Weaves of Fate",4000,6000,2000,3.99,50,25,2.99
"7105",7105,"Nyheim",3000,6000,3000,3.99,100,50,1.99
"7106",7106,"The Ditzy Demons Are in Love With Me",0,6000,6000,24.99,0,10,22.49
"7107",7107,"Achievement Lurker: Dad Jokes",2000,6000,4000,1.99,200,60,0.79
"7108",7108,"Girlfriend Cards",0,6000,6000,0.99,0,51,0.49
"7109",7109,"Beer Bar",0,6000,6000,0.99,0,51,0.49
"7110",7110,"Thea 2: The Shattering",0,6000,6000,24.99,0,10,22.49
"7111",7111,"DeerHunterX",2000,6000,4000,1.99,200,50,0.99
"7112",7112,"Trivia Vault: Golf Trivia",1000,6000,5000,1.99,500,75,0.49
"7113",7113,"XenoShyft",2000,6000,4000,9.99,200,61,3.89
"7114",7114,"PALEO museum VR",2000,6000,4000,1.99,200,20,1.59
"7115",7115,"Chamber 19",4000,6000,2000,14.99,50,0,14.99
"7116",7116,"9 Balls",1000,6000,5000,0.99,500,51,0.49
"7117",7117,"Raiden Legacy - Steam Edition",3000,6000,3000,9.99,100,50,4.99
"7118",7118,"Kitten Rampage",2000,6000,4000,7.99,200,50,3.99
"7119",7119,"Sorgina: A Tale of Witches",3000,6000,3000,9.99,100,70,2.99
"7120",7120,"SixGenerals | 六小将传说",2000,6000,4000,9.99,200,30,6.99
"7121",7121,"Hydroactive",3000,6000,3000,2.99,100,83,0.5
"7122",7122,"Cross And Crush",2000,6000,4000,3.99,200,75,1.99
"7123",7123,"Unstoppable Hamster",4000,6000,2000,4.99,50,87,0.5
"7124",7124,"Arevan",4000,6000,2000,7.99,50,90,0.79
"7125",7125,"与雾雨魔理沙一起偷重要的东西 ~ Happy Stealing with Kirisame Marisa",0,6000,6000,0.99,0,51,0.49
"7126",7126,"The Shadow of Hell",0,6000,6000,0.99,0,51,0.49
"7127",7127,"Phantom",2000,6000,4000,24.99,200,0,24.99
"7128",7128,"Alicia Quatermain: Secrets Of The Lost Treasures",2000,6000,4000,2.99,200,75,0.74
"7129",7129,"The Sunny Day 晴天",0,6000,6000,1.99,0,40,1.19
"7130",7130,"The Artifact",3000,6000,3000,7.99,100,55,3.59
"7131",7131,"Mogic",4000,6000,2000,0.99,50,51,0.49
"7132",7132,"Golf 2D",4000,6000,2000,1.99,50,75,0.49
"7133",7133,"Wrath of Loki VR Adventure",3000,6000,3000,2.99,100,84,0.49
"7134",7134,"Space Rocket",2000,6000,4000,0.99,200,51,0.49
"7135",7135,"Warlock Revenge",4000,6000,2000,2.99,50,83,0.5
"7136",7136,"The Cows Are Watching",3000,6000,3000,3.99,100,75,0.99
"7137",7137,"Holy Potatoes! What the Hell?!",4000,6000,2000,7.99,50,63,2.95
"7138",7138,"Escape From BioStation",4000,6000,2000,0.99,50,75,0.74
"7139",7139,"ClearMem :: Free Up Your RAM",0,6000,6000,9.99,0,51,4.89
"7140",7140,"Accounting+",0,6000,6000,11.99,0,15,10.19
"7141",7141,"Medieval Shopkeeper Simulator",3000,6000,3000,9.99,100,33,6.69
"7142",7142,"Idle Hunter",0,6000,6000,0.99,0,40,0.59
"7143",7143,"Agatha Knife",3000,6000,3000,11.99,100,50,5.99
"7144",7144,"Kittypocalypse - Ungoggled",4000,6000,2000,9.99,50,55,4.49
"7145",7145,"Train Simulator: London Subway",0,6000,6000,1.99,0,30,1.39
"7146",7146,"Sky Jac",3000,6000,3000,4.99,100,0,4.99
"7147",7147,"Escape the Mazes",3000,6000,3000,2.99,100,75,0.74
"7148",7148,"Beachhead 2002",2000,6000,4000,2.99,200,0,2.99
"7149",7149,"Hell in Paradise",3000,6000,3000,0.99,100,51,0.49
"7150",7150,"Tunnel Rats",2000,6000,4000,19.99,200,0,19.99
"7151",7151,"qop 3",4000,6000,2000,0.99,50,40,0.59
"7152",7152,"Viking's drakkars",3000,6000,3000,0.99,100,30,0.69
"7153",7153,"The friends of Ringo Ishikawa",3000,6000,3000,14.99,100,25,11.24
"7154",7154,"Cube Link",4000,6000,2000,4.99,50,80,0.59
"7155",7155,"Agricola: All Creatures Big and Small",1000,6000,5000,9.99,500,60,3.99
"7156",7156,"small pixel",0,6000,6000,1.99,0,60,0.79
"7157",7157,"Armor Clash II [RTS]",3000,6000,3000,9.99,100,50,4.99
"7158",7158,"Trivia Vault: Food Trivia",0,6000,6000,1.99,0,75,0.49
"7159",7159,"Defend the planet",3000,6000,3000,0.99,100,51,0.49
"7160",7160,"Trivia Vault: Literature Trivia",0,6000,6000,1.99,0,75,0.49
"7161",7161,"MXGP PRO",0,6000,6000,49.99,0,40,29.99
"7162",7162,"Rolling Shapes",4000,6000,2000,0.99,50,51,0.49
"7163",7163,"NEKO-NIN exHeart 2",3000,6000,3000,9.99,100,20,7.99
"7164",7164,"Winter Cold",4000,6000,2000,1.99,50,70,0.59
"7165",7165,"Crossroad Mysteries: The Broken Deal",4000,6000,2000,9.99,50,75,2.49
"7166",7166,"Grimm: Dark Legacy",4000,6000,2000,14.99,50,0,14.99
"7167",7167,"Scheming Through The Zombie Apocalypse: The Beginning",2000,6000,4000,4.99,200,50,2.49
"7168",7168,"TTV2",4000,6000,2000,0.99,50,51,0.49
"7169",7169,"Xenoraid: The First Space War",4000,6000,2000,9.99,50,75,2.49
"7170",7170,"Abstractism",3000,6000,3000,0.99,100,51,0.49
"7171",7171,"Hentai Epic Puzzles",0,6000,6000,0.99,0,25,0.74
"7172",7172,"Nightmare Simulator",0,6000,6000,2.99,0,30,2.09
"7173",7173,"Fossil Hunters",2000,6000,4000,14.99,200,65,5.24
"7174",7174,"Retro Miami",3000,6000,3000,0.99,100,51,0.49
"7175",7175,"Achievement Hunter: Kiborg",4000,6000,2000,0.99,50,51,0.49
"7176",7176,"Supreme: Pizza Empire",4000,6000,2000,9.99,50,80,1.99
"7177",7177,"Fairy of the treasures",4000,6000,2000,0.99,50,51,0.49
"7178",7178,"Neo Angle",3000,6000,3000,0.99,100,0,0.99
"7179",7179,"TankZone Battle",3000,6000,3000,9.99,100,75,2.24
"7180",7180,"Mystik Belle",3000,6000,3000,14.99,100,35,9.74
"7181",7181,"Fuego!",4000,6000,2000,4.99,50,0,4.99
"7182",7182,"Rifter",0,6000,6000,11.99,0,30,8.39
"7183",7183,"WinKings",4000,6000,2000,4.99,50,50,2.49
"7184",7184,"Onii-Chan",3000,6000,3000,1.99,100,45,1.09
"7185",7185,"MechRunner",4000,6000,2000,6.99,50,0,6.99
"7186",7186,"Robby's Adventure",2000,6000,4000,4.99,200,60,1.99
"7187",7187,"They Are Hundreds",2000,6000,4000,0.99,200,80,0.49
"7188",7188,"Lifeline",3000,6000,3000,3.99,100,60,1.59
"7189",7189,"Demon's Rise - Lords of Chaos",1000,6000,5000,6.99,500,50,3.49
"7190",7190,"CGWallpapers",2000,6000,4000,4.99,200,50,2.49
"7191",7191,"Choice of Magics",0,6000,6000,6.99,0,30,4.89
"7192",7192,"What is love?",1000,6000,5000,3.99,500,70,1.19
"7193",7193,"Trivia Vault: Business Trivia",1000,6000,5000,1.99,500,75,0.49
"7194",7194,"Gravity Light",1000,6000,5000,0.99,500,45,0.54
"7195",7195,"Roman The Worm",0,6000,6000,1.99,0,75,0.49
"7196",7196,"You Green Elephant",0,6000,6000,3.99,0,87,0.51
"7197",7197,"Infinite Air with Mark McMorris",4000,6000,2000,29.99,50,80,5.99
"7198",7198,"Birdtual Reality",3000,6000,3000,5.99,100,0,5.99
"7199",7199,"State of Mind",2000,6000,4000,29.99,200,50,14.99
"7200",7200,"Spaceguard 80",0,6000,6000,1.99,0,60,0.79
"7201",7201,"Are You Ready?",1000,6000,5000,0.99,500,69,0.49
"7202",7202,"Silent Descent",2000,6000,4000,8.99,200,65,3.14
"7203",7203,"Indie Pogo",0,6000,6000,14.99,0,0,14.99
"7204",7204,"Grottesco Absurdus",0,6000,6000,0.99,0,30,0.69
"7205",7205,"GoFetch",0,6000,6000,3.99,0,50,1.99
"7206",7206,"Copy Kitty",4000,6000,2000,14.99,50,40,8.99
"7207",7207,"Colonumbers",0,6000,6000,0.99,0,15,0.84
"7208",7208,"Initial 2 : New Stage",0,6000,6000,24.99,0,13,21.74
"7209",7209,"No70: Eye of Basir",3000,6000,3000,5.99,100,70,1.79
"7210",7210,"Injured by space",1000,6000,5000,0.99,500,51,0.49
"7211",7211,"Gardener the Ripper",4000,6000,2000,0.99,50,51,0.49
"7212",7212,"Project Defense",0,6000,6000,0.99,0,51,0.49
"7213",7213,"Eximius: Seize the Frontline",0,6000,6000,29.99,0,35,19.49
"7214",7214,"Labyrinths of Atlantis",3000,6000,3000,0.99,100,75,0.49
"7215",7215,"Wars Across The World",3000,6000,3000,9.99,100,50,7.49
"7216",7216,"Airport Simulator 2019",3000,6000,3000,19.99,100,33,13.39
"7217",7217,"鬼畜大冒险 Gui Chu Da Mao Xian",0,6000,6000,2.99,0,40,1.79
"7218",7218,"The Witch's House MV",0,6000,6000,14.99,0,10,13.49
"7219",7219,"Bitcoin VS Brain",1000,6000,5000,0.99,500,51,0.49
"7220",7220,"The soldier in the mine",4000,6000,2000,0.99,50,51,0.49
"7221",7221,"Squares Puzzle",0,6000,6000,0.99,0,30,0.69
"7222",7222,"Snail Trek - Chapter 1: Intershellar",2000,6000,4000,0.99,200,30,0.69
"7223",7223,"Germination",1000,6000,5000,3.99,500,69,1.23
"7224",7224,"Out of Ammo: Death Drive",3000,6000,3000,9.99,100,50,4.99
"7225",7225,"Mystery of Unicorn Castle: The Beastmaster",3000,6000,3000,6.99,100,80,1.39
"7226",7226,"PUSS!",0,6000,6000,9.99,0,30,6.99
"7227",7227,"Aveyond 3-3: The Lost Orb",4000,6000,2000,9.99,50,80,1.99
"7228",7228,"69",1000,6000,5000,0.99,500,30,0.69
"7229",7229,"R.B.I. Baseball 16",4000,6000,2000,19.99,50,0,19.99
"7230",7230,"Wolf & Rabbit",4000,6000,2000,1.99,50,33,1.33
"7231",7231,"Full Metal Renegade",0,6000,6000,6.99,0,50,3.49
"7232",7232,"Drusilla Dreams",3000,6000,3000,0.99,100,25,0.74
"7233",7233,"Lucky Shot",2000,6000,4000,0.99,200,51,0.49
"7234",7234,"Objects in Space",0,6000,6000,19.99,0,20,15.99
"7235",7235,"Wrongworld",3000,6000,3000,14.99,100,40,8.99
"7236",7236,"Lethis - Daring Discoverers",3000,6000,3000,12.99,100,75,3.24
"7237",7237,"The Shapeshifting Detective",0,6000,6000,12.99,0,20,10.39
"7238",7238,"Blueprint",2000,6000,4000,2.99,200,0,2.99
"7239",7239,"Snake Classic",4000,6000,2000,0.99,50,51,0.49
"7240",7240,"The Life of One Dog",0,6000,6000,0.99,0,51,0.49
"7241",7241,"Inferno Puzzle",4000,6000,2000,0.99,50,51,0.49
"7242",7242,"Land Doctrine",3000,6000,3000,4.99,100,50,2.49
"7243",7243,"Kolumno",0,6000,6000,1.99,0,25,1.49
"7244",7244,"Shiny Gauntlet",4000,6000,2000,0.99,50,45,0.54
"7245",7245,"Intelligence Trader",0,6000,6000,6.99,0,50,3.49
"7246",7246,"Claybook",4000,6000,2000,14.99,50,70,4.49
"7247",7247,"Disputed Space",3000,6000,3000,1.99,100,50,0.99
"7248",7248,"Arlo The Rabbit",3000,6000,3000,2.99,100,0,2.99
"7249",7249,"Elements: Epic Heroes",4000,6000,2000,6.99,50,0,6.99
"7250",7250,"Chinese inn",3000,6000,3000,7.99,100,20,6.39
"7251",7251,"Bottom of the 9th",1000,6000,5000,6.99,500,60,2.79
"7252",7252,"Satellite Command",4000,6000,2000,9.99,50,50,4.99
"7253",7253,"Pig Eat Ball",0,6000,6000,14.99,0,20,11.99
"7254",7254,"Think of the Children",3000,6000,3000,9.99,100,50,4.99
"7255",7255,"ABYSS CRAWLERS plus",4000,6000,2000,4.99,50,30,3.49
"7256",7256,"SG/ZH: School Girl/Zombie Hunter",4000,6000,2000,39.99,50,30,27.99
"7257",7257,"Pixel Traffic: Circle Rush",4000,6000,2000,1.99,50,75,0.49
"7258",7258,"Retro Sphere",3000,6000,3000,2.99,100,83,0.5
"7259",7259,"R.O.V.E.R.",1000,6000,5000,5.99,500,80,1.19
"7260",7260,"Just Ski",2000,6000,4000,2.99,200,67,0.98
"7261",7261,"Art of Guile",4000,6000,2000,4.99,50,75,1.24
"7262",7262,"Womb Room",4000,6000,2000,1.99,50,75,0.49
"7263",7263,"RaKoval~Nya: Escape Edition",4000,6000,2000,0.99,50,51,0.49
"7264",7264,"Interfectorem",2000,6000,4000,4.99,200,0,4.99
"7265",7265,"AVATAR: Consolidate",0,6000,6000,6.99,0,87,0.9
"7266",7266,"Metropolis: Lux Obscura",4000,6000,2000,7.99,50,30,5.59
"7267",7267,"Trivia Vault: Tennis Trivia",1000,6000,5000,1.99,500,75,0.49
"7268",7268,"Oik Memory",4000,6000,2000,0.99,50,37,0.62
"7269",7269,"Twisty's Asylum Escapades",4000,6000,2000,4.99,50,90,0.49
"7270",7270,"Littlewitch Romanesque: Editio Regia",4000,6000,2000,14.99,50,50,7.49
"7271",7271,"Jet Set Knights",4000,6000,2000,9.99,50,75,2.49
"7272",7272,"Lost In Space 2",3000,6000,3000,0.99,100,51,0.49
"7273",7273,"Online Circle Pong",3000,6000,3000,2.99,100,0,2.99
"7274",7274,"Kuro survival",4000,6000,2000,0.99,50,51,0.49
"7275",7275,"JetFLY : Zordon's EMPIRE",3000,6000,3000,0.99,100,0,0.99
"7276",7276,"My Coloring Book: Animals",3000,6000,3000,0.99,100,51,0.49
"7277",7277,"CASE 2: Animatronics Survival",0,6000,6000,7.99,0,30,5.59
"7278",7278,"Toys of War",4000,6000,2000,14.99,50,50,7.49
"7279",7279,"Sonya: The Great Adventure",4000,6000,2000,6.99,50,66,2.37
"7280",7280,"Sector Six",4000,6000,2000,9.99,50,75,2.49
"7281",7281,"Hush Hush - Unlimited Survival Horror",4000,6000,2000,1.99,50,50,0.99
"7282",7282,"Retaliation: Enemy Mine",2000,6000,4000,4.99,200,0,4.99
"7283",7283,"A Dump in the Dark",4000,6000,2000,2.99,50,80,0.59
"7284",7284,"Organ Quarter",4000,6000,2000,24.99,50,50,12.49
"7285",7285,"EverHero",1000,6000,5000,1.99,500,75,0.49
"7286",7286,"Training aim",1000,6000,5000,0.99,500,51,0.49
"7287",7287,"THE 2048",4000,6000,2000,0.99,50,51,0.49
"7288",7288,"Super Lucky's Tale",0,6000,6000,19.99,0,25,14.99
"7289",7289,"Click.O.Fast",0,6000,6000,0.99,0,51,0.49
"7290",7290,"Paintball 707",2000,6000,4000,4.99,200,25,3.74
"7291",7291,"Krita",4000,6000,2000,9.99,50,50,4.99
"7292",7292,"Prison Test",2000,6000,4000,0.99,200,51,0.49
"7293",7293,"The God Paradox",2000,6000,4000,4.99,200,0,4.99
"7294",7294,"DELTAZEAL",4000,6000,2000,11.99,50,55,5.39
"7295",7295,"Trivia Vault: Mixed Trivia 2",2000,6000,4000,4.99,200,90,0.49
"7296",7296,"Destiny of Light",4000,6000,2000,0.99,50,40,0.59
"7297",7297,"Princess Maker 5",3000,6000,3000,29.99,100,15,25.49
"7298",7298,"Romance of the Three Kingdoms IX with Power Up Kit / 三國志IX with パワーアップキット",3000,6000,3000,29.99,100,30,20.99
"7299",7299,"Murazu",2000,6000,4000,0.99,200,51,0.49
"7300",7300,"LOST SPHEAR",4000,6000,2000,49.99,50,60,19.99
"7301",7301,"Blacksmith Simulator",1000,6000,5000,4.99,500,70,1.49
"7302",7302,"Control Craft 3",4000,6000,2000,4.99,50,90,0.49
"7303",7303,"Blink",2000,6000,4000,6.99,200,85,1.04
"7304",7304,"Lazy Galaxy",3000,6000,3000,5.99,100,40,3.59
"7305",7305,"The Mystery of a Lost Planet",4000,6000,2000,4.99,50,60,1.99
"7306",7306,"Aesthetic Melody",4000,6000,2000,2.99,50,25,2.24
"7307",7307,"ViveSpray",4000,6000,2000,3.99,50,75,0.99
"7308",7308,"Slayer Shock",2000,6000,4000,19.99,200,70,5.99
"7309",7309,"Butterfly couple",0,6000,6000,0.99,0,51,0.49
"7310",7310,"The Ino Chronicles: Ascension",4000,6000,2000,1.99,50,50,0.99
"7311",7311,"Math Problem Challenge",2000,6000,4000,0.99,200,51,0.49
"7312",7312,"Mortal Squad: Portal to Hell",2000,6000,4000,3.99,200,80,0.79
"7313",7313,"Dreamlike Worlds",4000,6000,2000,0.99,50,30,0.69
"7314",7314,"Dandara",4000,6000,2000,14.99,50,45,8.24
"7315",7315,"Hell Knights",0,6000,6000,2.99,0,0,2.99
"7316",7316,"Sword Art Online: Lost Song",0,6000,6000,19.99,0,0,19.99
"7317",7317,"Train Journey",4000,6000,2000,1.99,50,65,0.69
"7318",7318,"Steam Squad",3000,6000,3000,17.99,100,90,1.79
"7319",7319,"Fugl",4000,6000,2000,9.99,50,40,5.99
"7320",7320,"Japanese Women - Animated Jigsaws",4000,6000,2000,9.99,50,90,0.99
"7321",7321,"Redirection",4000,6000,2000,7.99,50,64,2.87
"7322",7322,"Back in 1995",4000,6000,2000,9.99,50,40,5.99
"7323",7323,"Despotism 3k",0,6000,6000,7.99,0,10,7.19
"7324",7324,"Hamster Daily",0,6000,6000,0.99,0,51,0.49
"7325",7325,"Damascus Gear Operation Tokyo HD",2000,6000,4000,14.99,200,50,7.49
"7326",7326,"Anime girl Or Bottle?",4000,6000,2000,0.99,50,51,0.49
"7327",7327,"Beyond the Wall",3000,6000,3000,1.99,100,75,0.49
"7328",7328,"The Hex",0,6000,6000,9.99,0,15,8.49
"7329",7329,"Lost",2000,6000,4000,0.99,200,51,0.49
"7330",7330,"Rogue Trooper Redux",4000,6000,2000,24.99,50,66,8.49
"7331",7331,"Stunt Hill",3000,6000,3000,1.99,100,75,0.49
"7332",7332,"FRAMED Collection",2000,6000,4000,9.99,200,30,6.99
"7333",7333,"Trivia Vault: Hockey Trivia",4000,6000,2000,1.99,50,75,0.49
"7334",7334,"Last Anime Boy 2: Hentai Zombie Hell",4000,6000,2000,0.99,50,51,0.49
"7335",7335,"Bridge! 2",2000,6000,4000,9.99,200,55,4.49
"7336",7336,"ULTIMATE HARDBASS DEFENCE",0,6000,6000,1.99,0,30,1.39
"7337",7337,"Furry Animals Bombing",0,6000,6000,0.99,0,51,0.49
"7338",7338,"Trivia Vault: TV Trivia",3000,6000,3000,1.99,100,75,0.49
"7339",7339,"Temple Escape",4000,6000,2000,1.99,50,75,0.49
"7340",7340,"Aqua Fish",4000,6000,2000,1.99,50,70,0.59
"7341",7341,"Super Trashforce",3000,6000,3000,3.99,100,87,0.51
"7342",7342,"Space Chip",2000,6000,4000,0.99,200,0,0.99
"7343",7343,"Farm Frenzy: Hurricane Season",4000,6000,2000,6.99,50,90,0.69
"7344",7344,"Project 5: Sightseer",4000,6000,2000,19.99,50,10,17.99
"7345",7345,"Achievement Simulator 2018",4000,6000,2000,0.99,50,51,0.49
"7346",7346,"Tisnart Shapes",2000,6000,4000,4.99,200,50,2.49
"7347",7347,"Hentai Dojo",0,6000,6000,0.99,0,51,0.49
"7348",7348,"Yomawari: Midnight Shadows / 深夜廻",4000,6000,2000,29.99,50,40,17.99
"7349",7349,"Pixel Hentai Mosaic",0,6000,6000,0.99,0,45,0.54
"7350",7350,"Minotaur",3000,6000,3000,5.99,100,90,0.59
"7351",7351,"Treasure Adventure World",3000,6000,3000,9.99,100,35,6.49
"7352",7352,"Walls in Dead",3000,6000,3000,0.99,100,75,0.49
"7353",7353,"Zimbo",3000,6000,3000,0.99,100,51,0.49
"7354",7354,"Shock Tactics",3000,6000,3000,9.99,100,75,2.49
"7355",7355,"Lazy Devil's game life /废宅魔王的幸福生活",3000,6000,3000,0.99,100,30,0.69
"7356",7356,"Fall of Light",4000,6000,2000,14.99,50,67,4.94
"7357",7357,"SPAGHET",3000,6000,3000,1.99,100,0,1.99
"7358",7358,"Shape of America: Episode One",2000,6000,4000,4.99,200,60,1.99
"7359",7359,"Milky Way Map",4000,6000,2000,0.99,50,51,0.49
"7360",7360,"Blood of Magic",2000,6000,4000,9.99,200,0,9.99
"7361",7361,"Beglitched",4000,6000,2000,9.99,50,0,9.99
"7362",7362,"美丽新世界i Brave New World i",0,6000,6000,3.99,0,30,2.79
"7363",7363,"Vortex Rush",1000,6000,5000,1.99,500,75,0.49
"7364",7364,"Richy's Nightmares",0,6000,6000,2.99,0,75,0.74
"7365",7365,"Russian Front",4000,6000,2000,14.99,50,50,7.49
"7366",7366,"绝望游戏 / Desperate game",4000,6000,2000,3.99,50,40,2.39
"7367",7367,"Paperback: The Game",1000,6000,5000,4.99,500,0,4.99
"7368",7368,"Star Shelter",3000,6000,3000,14.99,100,30,10.49
"7369",7369,"Learn to Drive on Moto Wars",0,6000,6000,0.99,0,51,0.49
"7370",7370,"Sarab: Duji Tower",2000,6000,4000,1.99,200,50,0.99
"7371",7371,"Axis Football 2017",4000,6000,2000,14.99,50,10,13.49
"7372",7372,"Bitcoin Or Bomb?",3000,6000,3000,0.99,100,51,0.49
"7373",7373,"Andoran Skye 1.5",2000,6000,4000,14.99,200,40,8.99
"7374",7374,"Scrabble",4000,6000,2000,9.99,50,80,1.99
"7375",7375,"Tales of Nebezem: Elemental Link",3000,6000,3000,3.99,100,25,2.99
"7376",7376,"Morphite",2000,6000,4000,14.99,200,50,7.49
"7377",7377,"Leisure Suit Larry 5 - Passionate Patti Does a Little Undercover Work",4000,6000,2000,4.99,50,50,2.49
"7378",7378,"Ohr: אור",3000,6000,3000,5.99,100,85,0.89
"7379",7379,"Puzzle Master",0,6000,6000,1.99,0,40,1.19
"7380",7380,"Holy Avenger",1000,6000,5000,9.99,500,0,9.99
"7381",7381,"Sam & Max Hit the Road",0,6000,6000,5.99,0,40,3.59
"7382",7382,"Save The Villy",0,6000,6000,0.99,0,51,0.49
"7383",7383,"S.T.R.E.T.C.H.",1000,6000,5000,0.99,500,51,0.49
"7384",7384,"Airmen",2000,6000,4000,14.99,200,40,8.99
"7385",7385,"Thick Light",0,6000,6000,0.99,0,51,0.49
"7386",7386,"PUZZLE: LANDSCAPES",0,6000,6000,0.99,0,51,0.49
"7387",7387,"Boy Next Door",3000,6000,3000,0.99,100,51,0.49
"7388",7388,"Echoes III",0,6000,6000,9.99,0,30,6.99
"7389",7389,"BlowOut",2000,6000,4000,6.99,200,80,1.39
"7390",7390,"Ballistic Mini Golf",4000,6000,2000,4.99,50,50,2.49
"7391",7391,"Sweep'n'Sweep",2000,6000,4000,2.99,200,20,2.39
"7392",7392,"XING: The Land Beyond",3000,6000,3000,19.99,100,50,9.99
"7393",7393,"One Day in London",4000,6000,2000,9.99,50,10,8.99
"7394",7394,"Christmas Mahjong",0,6000,6000,4.99,0,40,2.99
"7395",7395,"M.A.X.: Mechanized Assault & Exploration",1000,6000,5000,9.99,500,66,3.39
"7396",7396,"A Long Way Home",4000,6000,2000,1.99,50,0,1.99
"7397",7397,"George VS Bonny PP Wars",1000,6000,5000,2.99,500,30,2.09
"7398",7398,"Mushroom rain",0,6000,6000,0.99,0,51,0.49
"7399",7399,"Cake Mania Collection",4000,6000,2000,14.99,50,0,14.99
"7400",7400,"Pub Encounter",4000,6000,2000,17.99,50,65,6.29
"7401",7401,"Operation: Matriarchy",4000,6000,2000,5.99,50,90,0.59
"7402",7402,"Wands",2000,6000,4000,14.99,200,35,9.74
"7403",7403,"Space Colonizers",1000,6000,5000,2.99,500,30,2.09
"7404",7404,"City Escaper",1000,5000,4000,0.99,400,51,0.49
"7405",7405,"Time Recoil",2000,5000,3000,13.99,150,70,4.19
"7406",7406,"Nebulous",3000,5000,2000,14.99,66.67,66,5.09
"7407",7407,"Settlements",2000,5000,3000,18.99,150,20,15.19
"7408",7408,"Forever Home",3000,5000,2000,0.99,66.67,84,0.49
"7409",7409,"Vietnam War PuZZles",2000,5000,3000,0.99,150,51,0.49
"7410",7410,"Romance with Chocolate - Hidden Object in Paris. HOPA",3000,5000,2000,2.99,66.67,50,1.49
"7411",7411,"Bastard",2000,5000,3000,8.99,150,60,3.59
"7412",7412,"Dungeon Rustlers",1000,5000,4000,4.99,400,90,0.49
"7413",7413,"Political puzzle",0,5000,5000,0.99,0,51,0.49
"7414",7414,"Gone Fireflies",1000,5000,4000,4.99,400,50,2.49
"7415",7415,"Tomato Jones 2",3000,5000,2000,1.99,66.67,50,0.99
"7416",7416,"Trivia Vault: Auto Racing Trivia",1000,5000,4000,1.99,400,75,0.49
"7417",7417,"Raiden V: Director's Cut | 雷電 V Director's Cut | 雷電V:導演剪輯版",3000,5000,2000,34.99,66.67,60,13.99
"7418",7418,"1942: The Pacific Air War",2000,5000,3000,6.99,150,75,1.74
"7419",7419,"Adventures of Mike",2000,5000,3000,0.99,150,51,0.49
"7420",7420,"Tenshu General",3000,5000,2000,5.99,66.67,0,5.99
"7421",7421,"Casino Inc.",3000,5000,2000,5.99,66.67,50,2.99
"7422",7422,"Bad Dream: Fever",0,5000,5000,9.99,0,20,7.99
"7423",7423,"苍夜",0,5000,5000,2.99,0,50,2.49
"7424",7424,"O! Nalchik is my favourite place",0,5000,5000,0.99,0,51,0.49
"7425",7425,"ZANGEKI WARP",1000,5000,4000,5.99,400,50,2.99
"7426",7426,"Ignition",2000,5000,3000,9.99,150,66,3.39
"7427",7427,"Algae",0,5000,5000,1.99,0,10,1.79
"7428",7428,"Dead By Murder",2000,5000,3000,2.99,150,83,0.5
"7429",7429,"The Legend of Bean",3000,5000,2000,2.99,66.67,65,1.04
"7430",7430,"DEFECTIVE",3000,5000,2000,3.99,66.67,70,1.19
"7431",7431,"Aircraft Evolution",3000,5000,2000,7.99,66.67,70,2.39
"7432",7432,"Delicious - Moms vs Dads",2000,5000,3000,12.99,150,50,6.49
"7433",7433,"Baseball Mogul 2017",2000,5000,3000,29.99,150,80,5.99
"7434",7434,"Trainiac",1000,5000,4000,2.99,400,80,0.59
"7435",7435,"Tank 51",3000,5000,2000,0.99,66.67,0,0.99
"7436",7436,"Ne no Kami: The Two Princess Knights of Kyoto",3000,5000,2000,9.99,66.67,55,4.49
"7437",7437,"Shuyan Saga",3000,5000,2000,19.99,66.67,75,4.99
"7438",7438,"Wunderwaffe",0,5000,5000,2.99,0,60,1.19
"7439",7439,"Baikonur Space",1000,5000,4000,0.99,400,51,0.49
"7440",7440,"Wild Unknown",3000,5000,2000,4.99,66.67,0,4.99
"7441",7441,"Massive",3000,5000,2000,9.99,66.67,90,0.99
"7442",7442,"Supermagical",3000,5000,2000,4.99,66.67,70,1.49
"7443",7443,"Bird couple",0,5000,5000,0.99,0,51,0.49
"7444",7444,"Christmas Carol",0,5000,5000,9.99,0,30,6.99
"7445",7445,"Street Karate",0,5000,5000,0.99,0,51,0.49
"7446",7446,"Legends of the Universe - StarCore",3000,5000,2000,3.99,66.67,88,0.49
"7447",7447,"The Plague",2000,5000,3000,5.99,150,0,5.99
"7448",7448,"Niko: Through The Dream",3000,5000,2000,9.99,66.67,70,2.99
"7449",7449,"Switch - Black & White",0,5000,5000,0.99,0,51,0.49
"7450",7450,"Kenshō",1000,5000,4000,3.99,400,50,1.99
"7451",7451,"Rayless",3000,5000,2000,1.99,66.67,33,1.33
"7452",7452,"Defect",2000,5000,3000,14.99,150,0,14.99
"7453",7453,"The Warrior Of Treasures",3000,5000,2000,0.99,66.67,51,0.49
"7454",7454,"Antisphere",3000,5000,2000,1.99,66.67,75,0.49
"7455",7455,"GOHOROBO",2000,5000,3000,3.99,150,30,2.79
"7456",7456,"Final Battle",2000,5000,3000,6.99,150,40,4.19
"7457",7457,"Sociable Soccer",3000,5000,2000,19.99,66.67,0,19.99
"7458",7458,"The Call",0,5000,5000,0.99,0,51,0.49
"7459",7459,"Robothorium: Sci-fi Dungeon Crawler",3000,5000,2000,14.99,66.67,34,9.89
"7460",7460,"Laserium",0,5000,5000,0.99,0,51,0.49
"7461",7461,"螢幕判官 Behind the Screen",3000,5000,2000,8.99,66.67,40,5.39
"7462",7462,"Spectrum Analyzer",3000,5000,2000,4.99,66.67,50,2.49
"7463",7463,"A Hand in the Darkness",3000,5000,2000,9.99,66.67,90,0.99
"7464",7464,"Fatal Fight",3000,5000,2000,2.99,66.67,0,2.99
"7465",7465,"SpaceBourne",0,5000,5000,14.99,0,20,11.99
"7466",7466,"Hentai Sokoban",0,5000,5000,0.99,0,40,0.59
"7467",7467,"Floor Kids",3000,5000,2000,19.9,66.67,40,11.94
"7468",7468,"Cloudrift",3000,5000,2000,6.99,66.67,20,5.59
"7469",7469,"Hentai Tentacle Bicycle Race",0,5000,5000,0.99,0,11,0.88
"7470",7470,"Squidlit",3000,5000,2000,2.99,66.67,34,1.97
"7471",7471,"Ecchi Cards",0,5000,5000,4.99,0,90,0.49
"7472",7472,"Endless Fables 2: Frozen Path",1000,5000,4000,14.99,400,40,8.99
"7473",7473,"The American Dream",2000,5000,3000,19.99,150,50,9.99
"7474",7474,"ISLAND",0,5000,5000,39.99,0,10,35.99
"7475",7475,"Gachimuchi Reloaded",1000,5000,4000,0.99,400,45,0.54
"7476",7476,"Chess Parallel Esports",0,5000,5000,4.99,0,0,4.99
"7477",7477,"Silenced: The House",1000,5000,4000,1.99,400,75,0.49
"7478",7478,"Robots.io",2000,5000,3000,7.99,150,90,0.79
"7479",7479,"Pure Hold'em",3000,5000,2000,19.99,66.67,60,7.99
"7480",7480,"George's Memories EP.1",0,5000,5000,1.99,0,75,0.49
"7481",7481,"LEGRAND LEGACY: Tale of the Fatebounds",3000,5000,2000,24.99,66.67,40,14.99
"7482",7482,"AngerDark",0,5000,5000,1.99,0,30,1.39
"7483",7483,"Ouroboros",3000,5000,2000,4.99,66.67,80,0.99
"7484",7484,"Far Out",2000,5000,3000,12.99,150,35,8.44
"7485",7485,"Villager's Biography",2000,5000,3000,1.99,150,50,0.99
"7486",7486,"Asura Valley",2000,5000,3000,1.99,150,70,0.59
"7487",7487,"Movavi Video Editor 14 Plus",0,5000,5000,59.99,0,65,20.99
"7488",7488,"Leisure Suit Larry 2 Looking For Love (In Several Wrong Places)",1000,5000,4000,3.99,400,50,1.99
"7489",7489,"InnerSpace",3000,5000,2000,19.99,66.67,60,7.99
"7490",7490,"Keep Rollin!",3000,5000,2000,1.99,66.67,75,0.49
"7491",7491,"Skirmish Line",3000,5000,2000,9.99,66.67,20,7.99
"7492",7492,"Amelon",1000,5000,4000,2.99,400,83,0.5
"7493",7493,"Epic Space",2000,5000,3000,24.99,150,0,24.99
"7494",7494,"My Coloring Book: Transport",2000,5000,3000,0.99,150,51,0.49
"7495",7495,"Fruit Pop II",0,5000,5000,1.99,0,40,1.19
"7496",7496,"Instinct",1000,5000,4000,4.99,400,50,2.49
"7497",7497,"BAJA: Edge of Control HD",3000,5000,2000,29.99,66.67,67,9.89
"7498",7498,"Marble It Up!",0,5000,5000,19.99,0,15,16.99
"7499",7499,"FAN'CIE VEER! (Fish Are Nasty, Cake Is Excellent Vektor Evading Emblazed Rapture)",0,5000,5000,1.99,0,75,0.49
"7500",7500,"Hunahpu Quest. Mechanoid",1000,5000,4000,4.99,400,90,0.49
"7501",7501,"Cat vs. Corgis",2000,5000,3000,6.99,150,0,6.99
"7502",7502,"Princess Lili - 丽丽公主",0,5000,5000,0.99,0,33,0.66
"7503",7503,"Yet Another Snake Game",0,5000,5000,0.99,0,51,0.49
"7504",7504,"Nimble Bunn",2000,5000,3000,0.99,150,51,0.49
"7505",7505,"Azurael's Circle: Chapter 3",0,5000,5000,1.99,0,20,1.59
"7506",7506,"Vigilantes",1000,5000,4000,14.99,400,20,10.79
"7507",7507,"Afternoon empire",3000,5000,2000,0.99,66.67,0,0.99
"7508",7508,"Jack the Barbarian",1000,5000,4000,2.99,400,75,0.74
"7509",7509,"Door",0,5000,5000,6.99,0,40,4.19
"7510",7510,"Chineze",2000,5000,3000,1.99,150,15,1.69
"7511",7511,"Virtual Virtual Reality",0,5000,5000,14.99,0,33,10.04
"7512",7512,"Bathroom Chef",1000,5000,4000,1.99,400,75,0.49
"7513",7513,"Range Ball",0,5000,5000,0.99,0,51,0.49
"7514",7514,"Ashes Cricket",3000,5000,2000,59.99,66.67,50,29.99
"7515",7515,"Romance of the Three Kingdoms X with Power Up Kit / 三國志X with パワーアップキット",3000,5000,2000,29.99,66.67,30,20.99
"7516",7516,"Mission: Escape from Island 3",2000,5000,3000,1.99,150,75,0.49
"7517",7517,"Shortest Trip to Earth",0,5000,5000,19.99,0,25,14.99
"7518",7518,"Achievement Hunter: Chef",2000,5000,3000,0.99,150,51,0.49
"7519",7519,"Helium Rain",2000,5000,3000,14.99,150,20,11.99
"7520",7520,"Multimaker",0,5000,5000,0.99,0,51,0.49
"7521",7521,"Boxes Inc.",1000,5000,4000,5.99,400,60,3.59
"7522",7522,"The New Girl",1000,5000,4000,1.99,400,75,0.49
"7523",7523,"TD Ultimate (Restocked)",0,5000,5000,1.99,0,75,0.49
"7524",7524,"The Ghost of Joe Papp",2000,5000,3000,5.99,150,30,4.19
"7525",7525,"Alice Mystery Garden",3000,5000,2000,4.99,66.67,34,3.29
"7526",7526,"Absolute Blue",1000,5000,4000,3.99,400,87,0.51
"7527",7527,"Cube Life: Island Survival",2000,5000,3000,14.99,150,80,2.99
"7528",7528,"FIRST TELEGRAM WAR",1000,5000,4000,0.99,400,51,0.49
"7529",7529,"Station 228",3000,5000,2000,0.99,66.67,51,0.49
"7530",7530,"The MISSING: J.J. Macfield and the Island of Memories",0,5000,5000,29.99,0,25,22.49
"7531",7531,"Cemetery Warrior 2",1000,5000,4000,1.99,400,75,0.49
"7532",7532,"Destination Dungeon: Crypts of Warthallow",3000,5000,2000,1.99,66.67,75,0.49
"7533",7533,"Clash of Castle",3000,5000,2000,0.99,66.67,51,0.49
"7534",7534,"TARTARUS",3000,5000,2000,19.99,66.67,75,4.99
"7535",7535,"Cat puzzle",0,5000,5000,4.99,0,50,2.49
"7536",7536,"RAIN Project - a touhou fangame",1000,5000,4000,7.99,400,0,7.99
"7537",7537,"Voidspire Tactics",3000,5000,2000,14.99,66.67,66,5.09
"7538",7538,"Deep Sixed",2000,5000,3000,12.99,150,40,7.79
"7539",7539,"Pro Gamer Tycoon",0,5000,5000,1.99,0,30,1.39
"7540",7540,"ASCENDANCE",2000,5000,3000,3.99,150,45,2.19
"7541",7541,"Yatsumitsu Fists of Wrath",3000,5000,2000,8.99,66.67,90,0.89
"7542",7542,"Hollow",3000,5000,2000,19.99,66.67,90,1.99
"7543",7543,"Zombie Office Politics",3000,5000,2000,4.99,66.67,50,2.49
"7544",7544,"Dusk Of Confinement",2000,5000,3000,0.99,150,30,0.69
"7545",7545,"LVN Fake News",0,5000,5000,3.99,0,50,1.99
"7546",7546,"ARENA GODS",2000,5000,3000,14.99,150,25,11.24
"7547",7547,"Rage Against The Zombies",3000,5000,2000,4.99,66.67,75,1.24
"7548",7548,"Lupinball",3000,5000,2000,9.99,66.67,60,3.99
"7549",7549,"Uganda know de way",2000,5000,3000,4.99,150,88,0.59
"7550",7550,"Black Roses",2000,5000,3000,0.99,150,0,0.99
"7551",7551,"Sweet Girl Adventure",0,5000,5000,0.99,0,45,0.54
"7552",7552,"Maybe Drinking. Russian Style",1000,5000,4000,0.99,400,51,0.49
"7553",7553,"Jagged Alliance: Rage!",0,5000,5000,19.99,0,10,17.99
"7554",7554,"Digital Dungeon",1000,5000,4000,4.99,400,75,2.24
"7555",7555,"夏之扉：最后的圣骑士",2000,5000,3000,8.99,150,30,6.29
"7556",7556,"ShadowSide",0,5000,5000,9.99,0,60,3.99
"7557",7557,"Mars or Die!",0,5000,5000,19.99,0,70,5.99
"7558",7558,"Elon Musk Simulator",0,5000,5000,0.99,0,51,0.49
"7559",7559,"Hentai Case Opening",0,5000,5000,0.99,0,51,0.49
"7560",7560,"Robot's Mystery",0,5000,5000,3.99,0,0,3.99
"7561",7561,"Framed Wings",1000,5000,4000,3.99,400,60,1.59
"7562",7562,"DesertShootout",3000,5000,2000,5.99,66.67,70,1.79
"7563",7563,"MyTD 我的塔防",3000,5000,2000,0.99,66.67,51,0.49
"7564",7564,"画境(Picturesque) VR",3000,5000,2000,4.99,66.67,0,4.99
"7565",7565,"Scavenger SV-4",3000,5000,2000,14.99,66.67,30,10.49
"7566",7566,"Light Repair Team #4",3000,5000,2000,4.99,66.67,66,2.49
"7567",7567,"Urban Explorer Golf",0,5000,5000,3.99,0,20,3.99
"7568",7568,"Slowdrive",2000,5000,3000,5.99,150,75,1.49
"7569",7569,"Halloween Forever",3000,5000,2000,4.99,66.67,40,2.99
"7570",7570,"Cherry Tree High Girls' Fight",2000,5000,3000,12.99,150,50,6.49
"7571",7571,"ChronoClock",3000,5000,2000,29.99,66.67,50,14.99
"7572",7572,"BQM - BlockQuest Maker-",0,5000,5000,9.99,0,15,8.49
"7573",7573,"Chilie Peppers",3000,5000,2000,1.99,66.67,65,0.69
"7574",7574,"War Hunter",1000,5000,4000,2.99,400,83,0.5
"7575",7575,"COMPOUND",3000,5000,2000,19.99,66.67,0,19.99
"7576",7576,"THE ART - Puzzle",0,5000,5000,0.99,0,51,0.49
"7577",7577,"LUMINES REMASTERED",0,5000,5000,14.99,0,35,9.74
"7578",7578,"Magic Scroll Tactics / マジックスクロールタクティクス / 魔法卷轴 / 魔法捲軸",1000,5000,4000,11.99,400,10,10.79
"7579",7579,"Number Guesser",3000,5000,2000,0.99,66.67,40,0.59
"7580",7580,"3D Paraglider",1000,5000,4000,1.99,400,50,0.99
"7581",7581,"Hyper Train Corporation",0,5000,5000,7.99,0,50,3.99
"7582",7582,"The m0rg VS keys",2000,5000,3000,0.99,150,51,0.49
"7583",7583,"Montaro RE",0,5000,5000,0.99,0,10,0.89
"7584",7584,"Mad Tower Tycoon",0,5000,5000,14.99,0,20,11.99
"7585",7585,"My 1/6 Lover",0,5000,5000,1.99,0,40,1.19
"7586",7586,"RetroMaze",1000,5000,4000,0.99,400,51,0.49
"7587",7587,"Undead Development",3000,5000,2000,17.99,66.67,50,8.99
"7588",7588,"Maze Walker",3000,5000,2000,1.99,66.67,75,0.49
"7589",7589,"Welcome to Hanwell",3000,5000,2000,19.99,66.67,90,1.99
"7590",7590,"魔王村长和杂货店-Hero Village Simulator",3000,5000,2000,2.99,66.67,30,2.09
"7591",7591,"Stream Avatars",3000,5000,2000,14.99,66.67,20,11.99
"7592",7592,"desTRUCKtors: Warfare Showdown",2000,5000,3000,4.99,150,75,1.49
"7593",7593,"Gravity Wars: Black Hole",0,5000,5000,0.99,0,40,0.59
"7594",7594,"Animals Memory: Dinosaurs",3000,5000,2000,0.99,66.67,51,0.49
"7595",7595,"Achievement Idler: Red",3000,5000,2000,0.99,66.67,0,0.99
"7596",7596,"!Dead Pixels Adventure!",1000,5000,4000,0.99,400,45,0.54
"7597",7597,"Sudoku Zenkai",1000,5000,4000,1.99,400,15,1.69
"7598",7598,"Seed of Evil",0,5000,5000,12.99,0,25,9.74
"7599",7599,"Karma",3000,5000,2000,0.99,66.67,0,0.99
"7600",7600,"Skyscrapers Puzzle: Airi's tale",0,5000,5000,3.99,0,15,3.39
"7601",7601,"Mojo",0,5000,5000,2.99,0,50,1.49
"7602",7602,"The Ultimate Clicker Master of the Universe",0,5000,5000,0.99,0,25,0.74
"7603",7603,"Animals Memory: Insect",2000,5000,3000,0.99,150,51,0.49
"7604",7604,"Speed Dating for Ghosts",2000,5000,3000,6.99,150,50,3.49
"7605",7605,"Brodefence",2000,5000,3000,4.99,150,25,3.74
"7606",7606,"Void Vikings",2000,5000,3000,4.99,150,60,1.99
"7607",7607,"Bandit Kings of Ancient China / 水滸伝・天命の誓い",3000,5000,2000,12.99,66.67,30,9.09
"7608",7608,"Russian world cup battlegrounds",0,5000,5000,0.99,0,51,0.49
"7609",7609,"Piano Play 3D",2000,5000,3000,3.99,150,75,1.24
"7610",7610,"Poltergeist: A Pixelated Horror",3000,5000,2000,7.99,66.67,0,7.99
"7611",7611,"Heroes Never Lose: Professor Puzzler's Perplexing Ploy",3000,5000,2000,8.99,66.67,0,8.99
"7612",7612,"Phantom Thief Celianna",0,5000,5000,12.99,0,25,9.74
"7613",7613,"TSIOQUE",0,5000,5000,13.99,0,20,11.19
"7614",7614,"Keep Running",0,5000,5000,0.99,0,25,0.74
"7615",7615,"E-Startup",3000,5000,2000,3.99,66.67,75,1.24
"7616",7616,"Time Trap - Mystery Hidden Objects",2000,5000,3000,3.99,150,45,2.19
"7617",7617,"Brick Breaker Premium",0,5000,5000,0.99,0,40,0.59
"7618",7618,"Fishing Sim World",0,5000,5000,39.99,0,40,23.99
"7619",7619,"Planet Unknown Runner",3000,5000,2000,0.99,66.67,51,0.49
"7620",7620,"Dog couple",0,5000,5000,0.99,0,51,0.49
"7621",7621,"Ashes of Immortality II - Bad Blood",3000,5000,2000,6.99,66.67,90,0.69
"7622",7622,"Pirate's Life",3000,5000,2000,4.99,66.67,0,4.99
"7623",7623,"Football Game",1000,5000,4000,1.99,400,50,0.99
"7624",7624,"Hallowed Encounter",3000,5000,2000,3.99,66.67,0,3.99
"7625",7625,"Chameleon Man",0,5000,5000,1.99,0,0,1.99
"7626",7626,"THE VIDEOKID",2000,5000,3000,3.99,150,50,1.99
"7627",7627,"Piano Bar",0,5000,5000,6.99,0,50,3.49
"7628",7628,"Eiyu*Senki – The World Conquest",3000,5000,2000,29.99,66.67,35,19.49
"7629",7629,"BAE 2",3000,5000,2000,1.99,66.67,75,0.49
"7630",7630,"Feeding The Monster",2000,5000,3000,1.99,150,75,0.49
"7631",7631,"The Eden of Grisaia",3000,5000,2000,29.99,66.67,40,17.99
"7632",7632,"ESport Manager",0,5000,5000,9.99,0,35,6.49
"7633",7633,"Zorbit's Orbits",3000,5000,2000,0.99,66.67,51,0.49
"7634",7634,"Lost in the Dungeon",3000,5000,2000,5.99,66.67,70,1.79
"7635",7635,"Pocket Rumble",3000,5000,2000,9.99,66.67,20,7.99
"7636",7636,"Conclave",3000,5000,2000,9.99,66.67,40,5.99
"7637",7637,"Sin Castle",3000,5000,2000,4.99,66.67,0,4.99
"7638",7638,"Let`s not stay friends",2000,5000,3000,5.99,150,80,1.59
"7639",7639,"Push Me Pull You",3000,5000,2000,14.99,66.67,66,5.09
"7640",7640,"Oafmatch",3000,5000,2000,5.99,66.67,50,2.99
"7641",7641,"Aground",0,5000,5000,9.99,0,0,9.99
"7642",7642,"Bump Bump Bump",2000,5000,3000,3.99,150,40,2.39
"7643",7643,"The Logomancer",3000,5000,2000,4.99,66.67,0,4.99
"7644",7644,"Bitcoin highway",3000,5000,2000,0.99,66.67,51,0.49
"7645",7645,"Your Car Shooter",0,5000,5000,0.99,0,51,0.49
"7646",7646,"Fashioning Little Miss Lonesome",3000,5000,2000,24.99,66.67,50,12.49
"7647",7647,"Old School Musical",0,5000,5000,12.99,0,20,10.39
"7648",7648,"Mindsight",2000,5000,3000,0.99,150,51,0.49
"7649",7649,"Achievement Machine",2000,5000,3000,3.99,150,75,0.99
"7650",7650,"CRIMSON METAL",2000,5000,3000,6.99,150,90,0.69
"7651",7651,"Sky Hunter",1000,5000,4000,10.99,400,50,5.49
"7652",7652,"Boss Defiance",3000,5000,2000,4.99,66.67,50,2.49
"7653",7653,"Lichtspeer",3000,5000,2000,9.99,66.67,80,1.99
"7654",7654,"Falling words",2000,5000,3000,0.99,150,51,0.49
"7655",7655,"Story of Eve - A Hero's Study",0,5000,5000,2.99,0,25,2.24
"7656",7656,"Super Night Riders",3000,5000,2000,7.99,66.67,75,1.99
"7657",7657,"Chinomikon",3000,5000,2000,0.99,66.67,25,0.74
"7658",7658,"Revolt",3000,5000,2000,4.99,66.67,0,4.99
"7659",7659,"Last Defense",2000,5000,3000,0.99,150,51,0.49
"7660",7660,"Basketball",0,5000,5000,3.99,0,66,1.35
"7661",7661,"Fitness Simulator",1000,5000,4000,3.99,400,50,1.99
"7662",7662,"Trivia Vault: Toy Trivia",0,5000,5000,1.99,0,75,0.49
"7663",7663,"Card City Nights 2",3000,5000,2000,7.99,66.67,50,4.99
"7664",7664,"TableTop Cricket",2000,5000,3000,9.99,150,50,4.99
"7665",7665,"Lamm",2000,5000,3000,2.99,150,83,0.5
"7666",7666,"Metamorfose S",3000,5000,2000,2.99,66.67,50,1.49
"7667",7667,"MEGALONIA",2000,5000,3000,0.99,150,51,0.49
"7668",7668,"Final Theosis",3000,5000,2000,4.99,66.67,60,1.99
"7669",7669,"Hakuoki: Edo Blossoms / 薄桜鬼 真改　華ノ章 / 薄櫻鬼 真改　華之章",3000,5000,2000,29.99,66.67,85,4.49
"7670",7670,"Kartong - Death by Cardboard!",1000,5000,4000,13.99,400,50,6.99
"7671",7671,"Tower Stacker",0,5000,5000,0.99,0,51,0.49
"7672",7672,"Rose of Winter",3000,5000,2000,11.99,66.67,60,4.79
"7673",7673,"WIL",1000,5000,4000,4.99,400,80,0.99
"7674",7674,"The Council of Hanwell",3000,5000,2000,7.99,66.67,90,0.79
"7675",7675,"Redrum: Dead Diary",3000,5000,2000,6.99,66.67,72,1.95
"7676",7676,"Bush Hockey League",3000,5000,2000,11.99,66.67,0,11.99
"7677",7677,"Hurricane Ship Ghost",0,5000,5000,0.99,0,51,0.49
"7678",7678,"Illwinter's Floorplan Generator",2000,5000,3000,6.99,150,30,4.89
"7679",7679,"Haters, kill them all!",3000,5000,2000,0.99,66.67,51,0.49
"7680",7680,"Torn",0,5000,5000,29.99,0,40,17.99
"7681",7681,"Transference",0,5000,5000,24.99,0,25,18.74
"7682",7682,"Welcome Back To 2007 2",0,5000,5000,1.99,0,75,0.49
"7683",7683,"Hiking Simulator 2017",3000,5000,2000,0.99,66.67,51,0.49
"7684",7684,"Trivia Vault: Fashion Trivia",0,5000,5000,1.99,0,75,0.49
"7685",7685,"Vogue, The Explorer",0,5000,5000,2.99,0,83,0.5
"7686",7686,"The Castle Disaster",3000,5000,2000,0.99,66.67,45,0.54
"7687",7687,"Nocturnal Hunt",3000,5000,2000,5.99,66.67,50,2.99
"7688",7688,"Fast Action Hero",3000,5000,2000,11.99,66.67,0,11.99
"7689",7689,"The mutton horn - Jump jump!",0,5000,5000,0.99,0,51,0.49
"7690",7690,"Bloody Sand",0,5000,5000,1.99,0,75,0.49
"7691",7691,"Fairyland: Fairylines",0,5000,5000,4.99,0,40,2.99
"7692",7692,"Simple Golfing",1000,5000,4000,2.99,400,83,0.5
"7693",7693,"Alter Cosmos",0,5000,5000,5.99,0,35,3.89
"7694",7694,"Rock Zombie",3000,5000,2000,6.99,66.67,30,4.89
"7695",7695,"Titanic VR",3000,5000,2000,19.99,66.67,50,7.49
"7696",7696,"Play With Me",1000,5000,4000,9.99,400,50,4.99
"7697",7697,"レイジングループ",3000,5000,2000,29.99,66.67,0,29.99
"7698",7698,"The Sapper",3000,5000,2000,2.99,66.67,84,0.49
"7699",7699,"MadOut Ice Storm",3000,5000,2000,6.99,66.67,60,2.79
"7700",7700,"Happy Empire - A Bouquet for the Princess",2000,5000,3000,4.99,150,40,2.99
"7701",7701,"Leviathan",0,5000,5000,0.99,0,51,0.49
"7702",7702,"Lagoon Lounge : The Poisonous Fountain",0,5000,5000,13.99,0,0,13.99
"7703",7703,"WolfWars",2000,5000,3000,3.99,150,70,1.49
"7704",7704,"SUPER IMPOSSIBLE ROAD",3000,5000,2000,14.99,66.67,33,8.7
"7705",7705,"Son of a Witch",2000,5000,3000,19.99,150,30,13.99
"7706",7706,"Ritter",0,5000,5000,0.99,0,51,0.49
"7707",7707,"ReSizE",3000,5000,2000,8.99,66.67,59,3.68
"7708",7708,"Black Jack Story",1000,5000,4000,0.99,400,51,0.49
"7709",7709,"Mass Destruction",2000,5000,3000,4.99,150,0,4.99
"7710",7710,"Last Heroes 4",3000,5000,2000,2.99,66.67,83,0.5
"7711",7711,"Evil Hazard",2000,5000,3000,2.99,150,0,2.99
"7712",7712,"Factory pirates",0,5000,5000,0.99,0,40,0.99
"7713",7713,"Segment",2000,5000,3000,5.99,150,90,0.59
"7714",7714,"Absence",3000,5000,2000,5.99,66.67,0,5.99
"7715",7715,"Bars and Balance",2000,5000,3000,1.99,150,70,0.59
"7716",7716,"Townsmen VR",3000,5000,2000,9.99,66.67,25,7.49
"7717",7717,"Landinar: Into the Void",0,5000,5000,15.99,0,0,15.99
"7718",7718,"Bokida - Heartfelt Reunion",3000,5000,2000,17.99,66.67,75,4.49
"7719",7719,"My Butler",3000,5000,2000,9.99,66.67,50,4.99
"7720",7720,"Red points",0,5000,5000,0.99,0,51,0.49
"7721",7721,"QLORB 2",3000,5000,2000,0.99,66.67,51,0.49
"7722",7722,"Ultimate Racing 2D",1000,5000,4000,9.99,400,30,6.99
"7723",7723,"Elven Legend",3000,5000,2000,1.99,66.67,50,0.99
"7724",7724,"Color Party",0,5000,5000,0.99,0,40,0.59
"7725",7725,"EEP 13",2000,5000,3000,34.99,150,75,8.74
"7726",7726,"Stellar Warrior",3000,5000,2000,1.99,66.67,75,0.49
"7727",7727,"Queen of Seas 2",1000,5000,4000,5.99,400,90,0.59
"7728",7728,"Jump To Die!!",3000,5000,2000,3.99,66.67,0,3.99
"7729",7729,"XWidget",0,5000,5000,3.99,0,40,2.39
"7730",7730,"Sword Legacy Omen",0,5000,5000,17.99,0,50,8.99
"7731",7731,"D3DGear - Game Recording and Streaming Software",3000,5000,2000,34.99,66.67,55,15.74
"7732",7732,"Ghostman: The Council Calamity",0,5000,5000,0.99,0,51,0.49
"7733",7733,"IWO: Bloodbath in the Bonins",1000,5000,4000,9.99,400,75,2.49
"7734",7734,"Pixel Robot Hunter",0,5000,5000,0.99,0,40,0.59
"7735",7735,"Oik Memory 2",2000,5000,3000,0.99,150,35,0.64
"7736",7736,"forma.8",3000,5000,2000,9.99,66.67,80,1.99
"7737",7737,"The Crown of Leaves",0,5000,5000,4.99,0,0,4.99
"7738",7738,"Slabo?",2000,5000,3000,2.99,150,70,0.89
"7739",7739,"Polygod",3000,5000,2000,9.99,66.67,75,3.39
"7740",7740,"Undead vs Plants",3000,5000,2000,6.99,66.67,0,6.99
"7741",7741,"Munch VR",3000,5000,2000,14.99,66.67,50,7.49
"7742",7742,"Wildlife Tycoon: Venture Africa",0,5000,5000,1.99,0,50,0.99
"7743",7743,"Slap Village: Reality Slap",3000,5000,2000,9.99,66.67,70,2.99
"7744",7744,"Cosmic Express",3000,5000,2000,9.99,66.67,66,3.39
"7745",7745,"American Patriots: Boston Tea Party",3000,5000,2000,0.99,66.67,37,0.62
"7746",7746,"The General Retreats",3000,5000,2000,4.99,66.67,0,4.99
"7747",7747,"Kamasutra Connect : Sexy Hentai Girls",0,5000,5000,0.99,0,0,0.99
"7748",7748,"Reformers Intl Ver(变革者国际版)",3000,5000,2000,1.99,66.67,50,0.99
"7749",7749,"Exorcism: Case Zero",1000,5000,4000,4.99,400,80,0.99
"7750",7750,"Kawaii Rainbow Portal",3000,5000,2000,0.99,66.67,51,0.49
"7751",7751,"#CuteSnake",3000,5000,2000,0.99,66.67,51,0.49
"7752",7752,"NEXT JUMP: Shmup Tactics",3000,5000,2000,4.99,66.67,75,1.24
"7753",7753,"ESSENCE",3000,5000,2000,20,66.67,25,15
"7754",7754,"M.I.A. - Overture",3000,5000,2000,14.99,66.67,50,7.49
"7755",7755,"Underhero",0,5000,5000,14.99,0,10,13.49
"7756",7756,"魔物娘物语",3000,5000,2000,0.99,66.67,40,0.59
"7757",7757,"Dive",2000,5000,3000,3.99,150,50,1.99
"7758",7758,"Wild RTS",3000,5000,2000,1.99,66.67,75,0.49
"7759",7759,"The Binding Of YOU",3000,5000,2000,1.99,66.67,60,0.79
"7760",7760,"Arma: Cold War Assault Mac/Linux",3000,5000,2000,4.99,66.67,80,0.99
"7761",7761,"Unrect",1000,5000,4000,2.99,400,50,1.49
"7762",7762,"Zwei: The Arges Adventure",2000,5000,3000,19.99,150,40,11.99
"7763",7763,"Soulblight",3000,5000,2000,14.99,66.67,40,8.99
"7764",7764,"Toxic Townsmen",2000,5000,3000,0.99,150,51,0.49
"7765",7765,"Macbat 64",3000,5000,2000,4.99,66.67,64,1.79
"7766",7766,"Perigee",0,5000,5000,1.99,0,0,1.99
"7767",7767,"Casual Penalty",1000,5000,4000,0.99,400,51,0.49
"7768",7768,"WARMA",0,5000,5000,11.99,0,70,3.59
"7769",7769,"Lands Of The Lost",2000,5000,3000,4.99,150,50,2.49
"7770",7770,"Awesome Pea",0,5000,5000,3.99,0,60,1.59
"7771",7771,"The Base",2000,5000,3000,0.99,150,87,0.49
"7772",7772,"Max's Big Bust - A Captain Nekorai Tale",3000,5000,2000,29.99,66.67,50,14.99
"7773",7773,"PaPaPub",0,5000,5000,2.99,0,30,2.09
"7774",7774,"Jailbreak Craft",0,5000,5000,0.99,0,51,0.49
"7775",7775,"Feather Of Praying 羽翼的祈愿",3000,5000,2000,1.99,66.67,33,1.33
"7776",7776,"Einlanzer",2000,5000,3000,3.99,150,80,0.79
"7777",7777,"J-Girl",0,5000,5000,3.99,0,15,3.39
"7778",7778,"MEANDERS",2000,5000,3000,2.99,150,70,0.89
"7779",7779,"Race.a.bit",3000,5000,2000,9.99,66.67,75,2.49
"7780",7780,"Dream Catcher Chronicles: Manitou",3000,5000,2000,9.99,66.67,50,4.99
"7781",7781,"Build-A-Lot",3000,5000,2000,9.99,66.67,0,9.99
"7782",7782,"ZombieHunt",3000,5000,2000,2.99,66.67,50,1.49
"7783",7783,"OboStar",0,5000,5000,1.99,0,75,0.49
"7784",7784,"New Frontier Days ~Founding Pioneers~",3000,5000,2000,9.99,66.67,50,4.99
"7785",7785,"Modern Tales: Age of Invention",2000,5000,3000,9.99,150,60,3.99
"7786",7786,"Card Crawl",3000,5000,2000,2.99,66.67,50,1.49
"7787",7787,"Up Left Out",0,5000,5000,0.99,0,15,0.84
"7788",7788,"TrickStyle",2000,5000,3000,5.99,150,60,2.39
"7789",7789,"WWII - TD",0,5000,5000,0.99,0,51,0.49
"7790",7790,"Duckpocalypse",3000,5000,2000,2.99,66.67,0,2.99
"7791",7791,"B.A.D Battle Armor Division",2000,5000,3000,5.99,150,75,1.49
"7792",7792,"Buff Knight Advanced",2000,5000,3000,2.99,150,50,1.49
"7793",7793,"Escape from Monkey Island",0,5000,5000,6.99,0,25,5.24
"7794",7794,"#CuteSnake 2",3000,5000,2000,0.99,66.67,51,0.49
"7795",7795,"Find The Balance",0,5000,5000,1.99,0,20,1.59
"7796",7796,"GRAVEN The Purple Moon Prophecy",2000,5000,3000,7.99,150,70,2.99
"7797",7797,"Futurespace (Alpha Edition)",0,5000,5000,9.99,0,0,9.99
"7798",7798,"ChessVR",2000,5000,3000,3.99,150,0,3.99
"7799",7799,"Blasted Road Terror",1000,5000,4000,8.99,400,50,4.49
"7800",7800,"Planum",3000,5000,2000,0.99,66.67,51,0.49
"7801",7801,"Special Warfare",0,5000,5000,4.99,0,43,3.98
"7802",7802,"Anguished",1000,5000,4000,0.99,400,40,0.59
"7803",7803,"FPS Monitor – in-game system & hardware sensors overlay",0,5000,5000,14.99,0,0,14.99
"7804",7804,"And So It Was",3000,5000,2000,9.99,66.67,75,0.49
"7805",7805,"Sniper Rust VR",0,5000,5000,9.99,0,0,9.99
"7806",7806,"Hollow Steps",1000,5000,4000,3.99,400,50,1.99
"7807",7807,"Super B-Dino's adventures",0,5000,5000,0.99,0,51,0.49
"7808",7808,"Gladiator: Sword of Vengeance",2000,5000,3000,7.99,150,65,2.79
"7809",7809,"Accurate Segmentation",0,5000,5000,0.99,0,51,0.49
"7810",7810,"World Circuit Boxing",2000,5000,3000,4.99,150,0,4.99
"7811",7811,"CUBE 332",0,5000,5000,0.99,0,51,0.49
"7812",7812,"Dark Parables: Curse of Briar Rose Collector's Edition",1000,5000,4000,9.99,400,60,3.99
"7813",7813,"O.C.D. - On Completeness & Dissonance",0,5000,5000,0.99,0,51,0.49
"7814",7814,"War of the Human Tanks - Limited Operations",3000,5000,2000,9.99,66.67,50,4.99
"7815",7815,"The Long Reach",2000,5000,3000,14.99,150,80,2.99
"7816",7816,"Desert Golfing",1000,5000,4000,1.99,400,25,1.49
"7817",7817,"Perfect Heist",2000,5000,3000,4.99,150,40,2.99
"7818",7818,"FYD",2000,5000,3000,1.99,150,75,0.49
"7819",7819,"Small Town Terrors: Galdor's Bluff Collector's Edition",2000,5000,3000,14.99,150,75,3.74
"7820",7820,"Verzaken! VR Adventure",2000,5000,3000,2.99,150,75,0.74
"7821",7821,"Plant Fire Department - The Simulation",3000,5000,2000,14.99,66.67,66,5.09
"7822",7822,"Tourist Bus Simulator",0,5000,5000,29.99,0,0,29.99
"7823",7823,"Tower Defense - Fantasy Legends Tower Game",2000,5000,3000,4.99,150,60,1.99
"7824",7824,"Elevator Ritual",1000,5000,4000,2.99,400,83,0.49
"7825",7825,"Your Ball Exploded",3000,5000,2000,0.99,66.67,51,0.49
"7826",7826,"Hyperun",3000,5000,2000,9.99,66.67,80,1.99
"7827",7827,"JQ: chemistry",2000,5000,3000,0.99,150,51,0.49
"7828",7828,"Edge",0,5000,5000,0.99,0,45,0.54
"7829",7829,"Bannerman",2000,4000,2000,11.99,100,60,5.99
"7830",7830,"Deliver Us The Moon: Fortuna",0,4000,4000,19.99,0,10,17.99
"7831",7831,"DUNGEONS OF CHAOS",2000,4000,2000,8.99,100,40,5.39
"7832",7832,"Tropical Girls VR",2000,4000,2000,4.99,100,70,1.49
"7833",7833,"Ragtag Adventurers",2000,4000,2000,6.99,100,0,6.99
"7834",7834,"15 seconds",1000,4000,3000,0.99,300,51,0.49
"7835",7835,"Spider Lander",0,4000,4000,2.99,0,0,2.99
"7836",7836,"3, 2, 1, SURVIVE !",2000,4000,2000,0.99,100,0,0.99
"7837",7837,"SEXUAL PUZZLE",0,4000,4000,0.99,0,40,0.59
"7838",7838,"Snake couple",0,4000,4000,0.99,0,51,0.49
"7839",7839,"Fabulous - Angela's Fashion Fever",2000,4000,2000,12.99,100,50,6.49
"7840",7840,"李教授的知识问答",0,4000,4000,0.99,0,51,0.49
"7841",7841,"Amberskull",1000,4000,3000,4.99,300,50,2.49
"7842",7842,"ECHO OF SOUL",0,4000,4000,8.99,0,40,5.39
"7843",7843,"Robikon",0,4000,4000,0.99,0,40,0.59
"7844",7844,"Arrowpoint",2000,4000,2000,0.99,100,25,0.74
"7845",7845,"Ninja from Hell vs. Reptiloids",0,4000,4000,0.99,0,51,0.49
"7846",7846,"The Music Room",1000,4000,3000,129.99,300,40,77.99
"7847",7847,"Alchemy of Castle",1000,4000,3000,0.99,300,51,0.49
"7848",7848,"Cryptozookeeper",0,4000,4000,4.99,0,20,3.99
"7849",7849,"Super Commander XL",0,4000,4000,0.99,0,51,0.49
"7850",7850,"Energy nodes",0,4000,4000,0.99,0,51,0.49
"7851",7851,"Kings",0,4000,4000,0.99,0,51,0.49
"7852",7852,"Unmanned helicopter",0,4000,4000,2.99,0,70,0.89
"7853",7853,"Space Hurricane Storm: 2 Edition",0,4000,4000,0.99,0,51,0.49
"7854",7854,"ALIENS INVADED OUR PLANET",1000,4000,3000,0.99,300,51,0.49
"7855",7855,"Muv-Luv",2000,4000,2000,29.99,100,40,17.99
"7856",7856,"Skylands",2000,4000,2000,13.99,100,90,1.39
"7857",7857,"Nancy Drew: Message in a Haunted Mansion",1000,4000,3000,9.99,300,40,5.99
"7858",7858,"Open The Door",1000,4000,3000,0.99,300,0,0.99
"7859",7859,"Indecision.",2000,4000,2000,2.99,100,67,0.98
"7860",7860,"Evolo.SpiderSim",0,4000,4000,0.99,0,51,0.49
"7861",7861,"Spelunker Party!",2000,4000,2000,29.99,100,50,14.99
"7862",7862,"Nancy Drew: The Secret of Shadow Ranch",2000,4000,2000,9.99,100,40,5.99
"7863",7863,"Beerd leaver",0,4000,4000,0.99,0,40,0.59
"7864",7864,"Elven Love",2000,4000,2000,14.99,100,30,10.49
"7865",7865,"Red and Blue ~ Cycles of Existence",0,4000,4000,0.99,0,33,0.66
"7866",7866,"Sword Bros",1000,4000,3000,4.99,300,33,3.34
"7867",7867,"Globe Rush",2000,4000,2000,2.99,100,0,2.99
"7868",7868,"UnHolY DisAsTeR",0,4000,4000,12.99,0,20,10.39
"7869",7869,"Wooden Ocean",1000,4000,3000,11.99,300,50,5.99
"7870",7870,"",2000,4000,2000,0.99,100,66,0.54
"7871",7871,"Voxel Race",0,4000,4000,0.99,0,51,0.49
"7872",7872,"NBA 2K Playgrounds 2",0,4000,4000,29.99,0,35,19.49
"7873",7873,"KIM and PROSTITUTE",2000,4000,2000,0.99,100,51,0.49
"7874",7874,"Bing Bong XL",1000,4000,3000,0.99,300,51,0.49
"7875",7875,"Fatal Twelve",1000,4000,3000,19.99,300,25,14.99
"7876",7876,"BATTLE ZOMBIE SHOOTER: SURVIVAL OF THE DEAD",1000,4000,3000,0.99,300,40,0.59
"7877",7877,"The Dark Occult",0,4000,4000,24.99,0,40,14.99
"7878",7878,"Achievement Hunter: Zombie 2",2000,4000,2000,0.99,100,51,0.49
"7879",7879,"Qvabllock",1000,4000,3000,0.99,300,51,0.49
"7880",7880,"Just Jump",2000,4000,2000,0.99,100,17,0.82
"7881",7881,"Home Security",0,4000,4000,4.99,0,0,4.99
"7882",7882,"Tenta Shooter / The 触シュー",2000,4000,2000,9.99,100,50,4.99
"7883",7883,"RPGolf",1000,4000,3000,3.99,300,75,0.99
"7884",7884,"CubeTime",0,4000,4000,0.99,0,51,0.49
"7885",7885,"Alien Invaders",0,4000,4000,0.99,0,51,0.49
"7886",7886,"Space Battlecruiser",2000,4000,2000,4.99,100,0,4.99
"7887",7887,"Bullyparade - DER Spiel",2000,4000,2000,9.99,100,75,2.49
"7888",7888,"Welcome Back Daddy",1000,4000,3000,6.99,300,75,1.74
"7889",7889,"The Sniper VR",1000,4000,3000,4.99,300,75,3.74
"7890",7890,"Hentai Space",0,4000,4000,0.99,0,51,0.49
"7891",7891,"Cryptochain",0,4000,4000,1.99,0,75,0.49
"7892",7892,"MiniOne Racing",2000,4000,2000,4.99,100,75,1.24
"7893",7893,"Robot Fighting",2000,4000,2000,4.99,100,75,1.24
"7894",7894,"Strategic Command WWII: World at War",0,4000,4000,39.99,0,0,39.99
"7895",7895,"We Are Chicago",1000,4000,3000,14.99,300,75,3.74
"7896",7896,"Space Rift - Episode 1",2000,4000,2000,19.99,100,70,5.99
"7897",7897,"Disassembly Line",1000,4000,3000,4.99,300,80,0.99
"7898",7898,"Anahita",2000,4000,2000,1.99,100,75,0.49
"7899",7899,"Debris",0,4000,4000,1.99,0,75,0.49
"7900",7900,"Medieval Battle Simulator",0,4000,4000,2.99,0,40,1.79
"7901",7901,"MMMmmm... Cake!",0,4000,4000,1.99,0,75,0.49
"7902",7902,"Aquarium Simulator",0,4000,4000,2.99,0,60,1.19
"7903",7903,"Gran Skrea Online",1000,4000,3000,9.99,300,10,8.99
"7904",7904,"Laser Ball",1000,4000,3000,1.99,300,83,0.49
"7905",7905,"Azurael's Circle: Chapter 2",0,4000,4000,1.99,0,50,0.99
"7906",7906,"Azorian Kings",1000,4000,3000,9.99,300,86,3.99
"7907",7907,"Voice Shooter ""Pif Paf""",0,4000,4000,1.99,0,25,1.49
"7908",7908,"Verdant Skies",1000,4000,3000,19.99,300,60,7.99
"7909",7909,"Super Punchman",2000,4000,2000,1.99,100,70,0.59
"7910",7910,"Trains of the Orient",0,4000,4000,6.99,0,30,4.89
"7911",7911,"Flamel's miracle（弗拉梅尔的奇迹）",2000,4000,2000,7.99,100,63,2.95
"7912",7912,"web spice",0,4000,4000,1.99,0,75,0.49
"7913",7913,"The Martian VR Experience",2000,4000,2000,4.99,100,0,4.99
"7914",7914,"Live",2000,4000,2000,1.99,100,75,0.49
"7915",7915,"The 111th Soul",1000,4000,3000,0.99,300,51,0.49
"7916",7916,"Spaceguy 2",2000,4000,2000,3.99,100,25,2.99
"7917",7917,"Blood Alloy: Reborn",2000,4000,2000,12.99,100,80,2.59
"7918",7918,"Saint Slaughter X Days",0,4000,4000,2.99,0,60,1.19
"7919",7919,"Upwards, Lonely Robot",2000,4000,2000,9.99,100,85,1.49
"7920",7920,"Zarya and the Cursed Skull",1000,4000,3000,9.99,300,75,2.49
"7921",7921,"Shepherds of the Abyss",1000,4000,3000,5.99,300,0,5.99
"7922",7922,"Fantasyland",1000,4000,3000,8.99,300,75,2.24
"7923",7923,"glutton man",2000,4000,2000,1.99,100,75,0.49
"7924",7924,"Dark Throne",1000,4000,3000,0.99,300,51,0.49
"7925",7925,"The King's Heroes",2000,4000,2000,9.99,100,90,0.99
"7926",7926,"Semblance",0,4000,4000,9.99,0,30,6.99
"7927",7927,"ReHack",1000,4000,3000,3.99,300,88,0.49
"7928",7928,"The Lost Legends of Redwall : The Scout",2000,4000,2000,14.99,100,40,8.99
"7929",7929,"FanTris",0,4000,4000,0.99,0,51,0.49
"7930",7930,"Battleship Lonewolf",1000,4000,3000,7.99,300,60,3.19
"7931",7931,"Othello 2018",0,4000,4000,0.99,0,51,0.49
"7932",7932,"Alone in the Dark 3",1000,4000,3000,14.99,300,75,3.74
"7933",7933,"Haque",2000,4000,2000,14.99,100,50,7.49
"7934",7934,"Color Cingdom",2000,4000,2000,0.99,100,51,0.49
"7935",7935,"Achievement Hunter: Zombie 3",2000,4000,2000,0.99,100,51,0.49
"7936",7936,"Daddy",2000,4000,2000,2.99,100,70,0.89
"7937",7937,"HYPERGUN",0,4000,4000,14.99,0,40,8.99
"7938",7938,"Mall Mayhem",2000,4000,2000,1.99,100,87,0.51
"7939",7939,"AO International Tennis",2000,4000,2000,29.99,100,50,14.99
"7940",7940,"Sea Of Fatness: Save Humanity Together",2000,4000,2000,2.99,100,33,2.99
"7941",7941,"Grandpa's Table",2000,4000,2000,4.99,100,75,1.24
"7942",7942,"梦三英雄传/Three Kingdoms: Legends of Heroes",0,4000,4000,5.99,0,35,3.89
"7943",7943,"ChromaSquares",0,4000,4000,4.99,0,0,4.99
"7944",7944,"DISTRAINT 2",0,4000,4000,8.99,0,10,8.09
"7945",7945,"Puzzles for smart: Birds",0,4000,4000,1.99,0,55,0.89
"7946",7946,"Voxel Blast",2000,4000,2000,11.99,100,0,11.99
"7947",7947,"Griefer",1000,4000,3000,0.99,300,51,0.49
"7948",7948,"ZombieFight VR",2000,4000,2000,19.99,100,0,19.99
"7949",7949,"H.I.S.T.O.R.Y T.O.R.C.H.K.A 2",2000,4000,2000,2.99,100,60,1.19
"7950",7950,"Floor Plan: Hands-On Edition",2000,4000,2000,5.99,100,50,2.99
"7951",7951,"FIGHTING SPACE",2000,4000,2000,4.99,100,0,4.99
"7952",7952,"SYMMETRIC",0,4000,4000,0.99,0,40,0.59
"7953",7953,"Creepy Road",2000,4000,2000,9.99,100,50,4.99
"7954",7954,"Righty Tighty XL",1000,4000,3000,0.99,300,51,0.49
"7955",7955,"SLICE",2000,4000,2000,0.99,100,51,0.49
"7956",7956,"Gods of the Fallen Land",2000,4000,2000,4.99,100,35,3.24
"7957",7957,"Outbreak: The Nightmare Chronicles",1000,4000,3000,4.99,300,60,1.99
"7958",7958,"Blind Bird",0,4000,4000,0.99,0,51,0.49
"7959",7959,"Golden Krone Hotel",2000,4000,2000,9.99,100,60,3.99
"7960",7960,"Achievement Hunter: Princess",2000,4000,2000,0.99,100,51,0.49
"7961",7961,"Rogue Islands",2000,4000,2000,19.99,100,50,9.99
"7962",7962,"Sky Is Arrows",2000,4000,2000,9.99,100,90,0.99
"7963",7963,"Ecchi Puzzle",0,4000,4000,0.99,0,51,0.49
"7964",7964,"Ghost Killer",1000,4000,3000,2.99,300,83,0.5
"7965",7965,"Gray Dawn",2000,4000,2000,19.99,100,30,13.99
"7966",7966,"Dark Matter",1000,4000,3000,0.99,300,51,0.49
"7967",7967,"Atelier Rorona ~The Alchemist of Arland~ DX - ロロナのアトリエ ～アーランドの錬金術士～ DX",0,4000,4000,39.99,0,0,39.99
"7968",7968,"#Archery",2000,4000,2000,9.99,100,50,4.99
"7969",7969,"校园恋物语|Love in School",0,4000,4000,0.99,0,40,0.59
"7970",7970,"Doomed'n Damned",2000,4000,2000,5.99,100,0,5.99
"7971",7971,"SlimeGear",0,4000,4000,4.99,0,0,4.99
"7972",7972,"Hyper Bowling VR",1000,4000,3000,4.99,300,50,2.49
"7973",7973,"Neon Void Runner",0,4000,4000,1.99,0,75,0.49
"7974",7974,"Marginal act",2000,4000,2000,1.99,100,75,0.49
"7975",7975,"Garden Tale",2000,4000,2000,9.99,100,50,4.99
"7976",7976,"FPV Air 2",0,4000,4000,4.99,0,40,2.99
"7977",7977,"Diner Bros",0,4000,4000,9.99,0,15,8.49
"7978",7978,"Doctor Watson - The Riddle of the Catacombs",2000,4000,2000,7.99,100,70,2.39
"7979",7979,"CandySnake",2000,4000,2000,0.99,100,51,0.49
"7980",7980,"Worshippers",2000,4000,2000,9.99,100,50,4.99
"7981",7981,"Starfighter Origins",2000,4000,2000,19.99,100,80,3.99
"7982",7982,"Z ViRus: V.I.R.M Uprising",0,4000,4000,19.99,0,0,19.99
"7983",7983,"The Tavern",1000,4000,3000,4.99,300,90,0.49
"7984",7984,"Balls and Magnets",1000,4000,3000,1.99,300,75,0.49
"7985",7985,"Boss 101",1000,4000,3000,14.99,300,90,1.49
"7986",7986,"Overcoming Pain",2000,4000,2000,2.99,100,70,0.89
"7987",7987,"Music Maker 2017 Premium Steam Edition",2000,4000,2000,119.99,100,75,29.99
"7988",7988,"Whirlygig",0,4000,4000,2.99,0,50,1.49
"7989",7989,"Mr Rabbit's Alphabet Forest Adventure",1000,4000,3000,4.99,300,70,1.49
"7990",7990,"My Personal Angel",1000,4000,3000,9.99,300,75,2.49
"7991",7991,"NITE Team 4",0,4000,4000,29.99,0,15,25.49
"7992",7992,"Sakura Day Mahjong",0,4000,4000,4.99,0,90,0.49
"7993",7993,"TrES-2b",2000,4000,2000,0.99,100,0,0.99
"7994",7994,"Hallo Spaceboy",1000,4000,3000,2.99,300,80,0.59
"7995",7995,"Horny Fighter",0,4000,4000,0.99,0,51,0.49
"7996",7996,"A Flappy Bird in Real Life",0,4000,4000,1.99,0,15,1.69
"7997",7997,"Bleeding Sun",0,4000,4000,5.99,0,50,4.49
"7998",7998,"Monkey King: Master of the Clouds | 中華大仙",0,4000,4000,4.99,0,60,1.99
"7999",7999,"DungeonGOGO",1000,4000,3000,6.99,300,0,6.99
"8000",8000,"Bounty Hunter: Space Detective",2000,4000,2000,1.99,100,50,0.99
"8001",8001,"Sandmade",1000,4000,3000,0.99,300,15,0.84
"8002",8002,"Knight Fighter",1000,4000,3000,0.99,300,51,0.49
"8003",8003,"Distant castle",2000,4000,2000,1.99,100,30,1.39
"8004",8004,"Naked Sun",0,4000,4000,15.99,0,30,11.19
"8005",8005,"Achievement Hunter: Punk",2000,4000,2000,0.99,100,51,0.49
"8006",8006,"Mortal box",0,4000,4000,1.99,0,20,1.59
"8007",8007,"Nurikabe",0,4000,4000,0.99,0,0,0.99
"8008",8008,"100nya",2000,4000,2000,2.79,100,66,0.94
"8009",8009,"The Spectrum Retreat",0,4000,4000,12.99,0,60,5.19
"8010",8010,"Oscillatron: Alien Frequency",1000,4000,3000,3.99,300,75,0.99
"8011",8011,"Market Tycoon",2000,4000,2000,9.99,100,40,5.99
"8012",8012,"Ghostlords",2000,4000,2000,9.99,100,80,1.99
"8013",8013,"1943 Megami Strike",2000,4000,2000,8.99,100,0,8.99
"8014",8014,"Mad Factory",0,4000,4000,3.99,0,0,3.99
"8015",8015,"The Rabbit Hole Remastered",2000,4000,2000,3.99,100,87,0.51
"8016",8016,"HANZ!",0,4000,4000,4.99,0,80,0.99
"8017",8017,"Ranger vs. Space Mutants",1000,4000,3000,3.99,300,87,0.51
"8018",8018,"CHANGE: A Homeless Survival Experience",0,4000,4000,9.99,0,25,7.49
"8019",8019,"Escape Doodland",0,4000,4000,9.99,0,20,7.99
"8020",8020,"Thunder Kid",0,4000,4000,7.99,0,25,5.99
"8021",8021,"Ripped Pants at Work",2000,4000,2000,2.99,100,70,0.89
"8022",8022,"Sweven",2000,4000,2000,1.99,100,0,1.99
"8023",8023,"Turret Tech",0,4000,4000,5.99,0,90,0.59
"8024",8024,"Dreamstones",1000,4000,3000,11.99,300,50,5.99
"8025",8025,"Jumper Magic",0,4000,4000,2.99,0,50,1
"8026",8026,"Fureraba ~Friend to Lover~",2000,4000,2000,29.99,100,30,20.99
"8027",8027,"Fight desserts",2000,4000,2000,0.99,100,40,0.59
"8028",8028,"The Darkest Woods",0,4000,4000,2.99,0,50,0.99
"8029",8029,"One Clone Left",1000,4000,3000,7.99,300,50,3.99
"8030",8030,"Starcaster",0,4000,4000,2.99,0,80,0.59
"8031",8031,"Lost Artifacts - Ancient Tribe Survival",2000,4000,2000,4.99,100,90,0.49
"8032",8032,"The Haunted Island, a Frog Detective Game",0,4000,4000,4.99,0,10,4.49
"8033",8033,"Friday Night Bullet Arena",2000,4000,2000,9.99,100,85,1.49
"8034",8034,"Substance Painter 2019",0,4000,4000,149.99,0,34,98.99
"8035",8035,"Opus Mortem",0,4000,4000,1.99,0,10,1.79
"8036",8036,"Prodigy Tactics",2000,4000,2000,19.99,100,50,9.99
"8037",8037,"Wandersong",0,4000,4000,19.99,0,10,17.99
"8038",8038,"Subway Surfers 2018 - Pet vs Police",0,4000,4000,4.99,0,80,0.99
"8039",8039,"Dungeon Girl",0,4000,4000,11.99,0,20,9.59
"8040",8040,"Car Demolition Clicker",0,4000,4000,6.99,0,40,4.19
"8041",8041,"One Night Two Crazies",2000,4000,2000,0.99,100,51,0.49
"8042",8042,"Do you know de way",1000,4000,3000,0.99,300,51,0.49
"8043",8043,"Save One More",2000,4000,2000,5.99,100,40,3.59
"8044",8044,"Paratopic",0,4000,4000,5.49,0,20,4.39
"8045",8045,"Gulman 4: Still alive",2000,4000,2000,8.99,100,0,8.99
"8046",8046,"JUST DASH",0,4000,4000,2.99,0,20,2.39
"8047",8047,"Space Leprechaun",1000,4000,3000,2.99,300,83,0.5
"8048",8048,"CuberPunk 2089",0,4000,4000,0.99,0,40,0.59
"8049",8049,"Warparty",0,4000,4000,17.99,0,25,13.49
"8050",8050,"Kaori After Story",0,4000,4000,9.99,0,15,8.49
"8051",8051,"Alchemage",2000,4000,2000,9.99,100,0,9.99
"8052",8052,"Hentai Hunter",0,4000,4000,0.99,0,35,0.64
"8053",8053,"Cry of War",1000,4000,3000,2.99,300,30,0.99
"8054",8054,"Another Sight",0,4000,4000,19.99,0,40,11.99
"8055",8055,"Geeste",1000,4000,3000,2.99,300,40,1.79
"8056",8056,"淑女同萌！HELLO LADY!",0,4000,4000,29.99,0,45,16.49
"8057",8057,"Putin VS ISIS",1000,4000,3000,0.99,300,51,0.49
"8058",8058,"Zombow",2000,4000,2000,0.99,100,75,0.49
"8059",8059,"CAR THIEF SIMULATOR 2017",1000,4000,3000,9.99,300,70,2.99
"8060",8060,"Space Pilgrim Academy: Year 2",2000,4000,2000,1.99,100,50,0.99
"8061",8061,"Turtle Lu",0,4000,4000,2.99,0,83,0.5
"8062",8062,"I ♥ You!",0,4000,4000,0.99,0,51,0.49
"8063",8063,"Strangers of the Power",2000,4000,2000,1.99,100,50,0.99
"8064",8064,"The Mind of Marlo",1000,4000,3000,2.99,300,80,0.59
"8065",8065,"The Curse Of Yendor",2000,4000,2000,4.99,100,50,2.49
"8066",8066,"Override: Mech City Brawl",0,4000,4000,29.99,0,0,29.99
"8067",8067,"Jettomero: Hero of the Universe",2000,4000,2000,12.99,100,60,5.19
"8068",8068,"Cat couple",0,4000,4000,0.99,0,51,0.49
"8069",8069,"Mobile Forces",0,4000,4000,3.99,0,70,1.19
"8070",8070,"Puzzle Chambers",2000,4000,2000,2.99,100,83,0.5
"8071",8071,"Coffee Crisis",2000,4000,2000,9.99,100,80,1.99
"8072",8072,"Captain Forever Trilogy",2000,4000,2000,9.99,100,24,7.59
"8073",8073,"Ero Date",0,4000,4000,1.49,0,50,0.74
"8074",8074,"Pi is Everything",0,4000,4000,3.14,0,0,3.14
"8075",8075,"WORLD HENTAI",0,4000,4000,0.99,0,40,0.59
"8076",8076,"Solmec: Among Stars",2000,4000,2000,0.99,100,0,0.99
"8077",8077,"Order No. 227: Not one step back!",0,4000,4000,4.99,0,83,0.84
"8078",8078,"Hikikomori No Chuunibyou",2000,4000,2000,1.99,100,60,0.79
"8079",8079,"Sign Here: _________",1000,4000,3000,0.99,300,51,0.49
"8080",8080,"Oh My Godheads",2000,4000,2000,14.99,100,40,8.99
"8081",8081,"BAFL - Brakes Are For Losers",1000,4000,3000,9.99,300,70,2.99
"8082",8082,"Disjoint",2000,4000,2000,2.99,100,0,2.99
"8083",8083,"Romance of the Three Kingdoms　VIII with Power Up Kit / 三國志VIII with パワーアップキット",2000,4000,2000,19.99,100,30,13.99
"8084",8084,"Quixzel Rush Halloween Party",0,4000,4000,0.99,0,51,0.49
"8085",8085,"Lanterns",1000,4000,3000,7.99,300,0,3.99
"8086",8086,"Log Drive Runner",1000,4000,3000,6.99,300,86,0.97
"8087",8087,"Thief of Thieves: Season One",0,4000,4000,19.99,0,25,14.99
"8088",8088,"Lake Ridden",2000,4000,2000,19.99,100,30,13.99
"8089",8089,"Quantum Retribution",0,4000,4000,6.99,0,30,4.89
"8090",8090,"Big Dick",0,4000,4000,0.99,0,30,0.69
"8091",8091,"Splitter Critters",1000,4000,3000,6.99,300,80,1.39
"8092",8092,"Earth Liberation",2000,4000,2000,6.99,100,0,6.99
"8093",8093,"Lots of Balls",1000,4000,3000,2.99,300,87,0.49
"8094",8094,"Kukoo Kitchen",0,4000,4000,7.99,0,20,6.39
"8095",8095,"Type",0,4000,4000,0.99,0,51,0.49
"8096",8096,"fpsVR",0,4000,4000,3.99,0,30,2.79
"8097",8097,"Picross Fairytale: Legend of the Mermaid",0,4000,4000,4.99,0,90,0.49
"8098",8098,"Copierre",2000,4000,2000,4.99,100,20,3.99
"8099",8099,"The Sum of All Fears",2000,4000,2000,9.99,100,75,2.49
"8100",8100,"Little Cells",2000,4000,2000,3.99,100,85,0.59
"8101",8101,"Pixel To The West",2000,4000,2000,4.99,100,67,1.64
"8102",8102,"Lovers ' Smiles",0,4000,4000,1.99,0,40,1.19
"8103",8103,"AFL Evolution",2000,4000,2000,49.99,100,50,24.99
"8104",8104,"Hentai Loli vs Pedobear",0,4000,4000,0.99,0,13,0.86
"8105",8105,"天风之光 ~ Touhou Fan of Destiny",0,4000,4000,12.99,0,30,9.09
"8106",8106,"Code 7: A Story-Driven Hacking Adventure",2000,4000,2000,16.99,100,30,11.89
"8107",8107,"FlowDot",0,4000,4000,1.99,0,0,1.99
"8108",8108,"Russian AYE Horror",1000,4000,3000,0.99,300,51,0.49
"8109",8109,"Sea Dogs",2000,4000,2000,11.99,100,75,2.99
"8110",8110,"Suki's Spooky Romance",0,4000,4000,2.99,0,50,1.49
"8111",8111,"MODO indie 901",2000,4000,2000,14.99,100,0,14.99
"8112",8112,"Escape the Enterprise/逃离企业号",0,4000,4000,0.99,0,30,0.69
"8113",8113,"Hillbilly Apocalypse",0,4000,4000,5.99,0,10,5.39
"8114",8114,"The Fruitless Flower 雾雨中的徒花",2000,4000,2000,0.99,100,51,0.49
"8115",8115,"Dragon Hunter",2000,4000,2000,2.99,100,84,0.49
"8116",8116,"Gravity Jump",0,4000,4000,1.99,0,70,0.59
"8117",8117,"Suitchi",0,4000,4000,2.99,0,50,1.49
"8118",8118,"Super Treasure Arena",2000,4000,2000,7.99,100,60,3.19
"8119",8119,"Brick Breaker Premium 3",0,4000,4000,0.99,0,40,0.59
"8120",8120,"Uurnog Uurnlimited",2000,4000,2000,14.99,100,55,6.74
"8121",8121,"Ayo: A Rain Tale",1000,4000,3000,9.99,300,80,1.99
"8122",8122,"S.U.B.",2000,4000,2000,1.99,100,50,0.99
"8123",8123,"Metal Tales: Fury of the Guitar Gods",2000,4000,2000,6.99,100,75,1.74
"8124",8124,"BLOCK CAT SPACE GOLF",0,4000,4000,1.99,0,0,1.99
"8125",8125,"Ashley: The Story Of Survival",2000,4000,2000,3.99,100,65,1.99
"8126",8126,"Cycle 28",1000,4000,3000,4.99,300,40,2.99
"8127",8127,"Flaming Pixels",0,4000,4000,5.99,0,50,2.99
"8128",8128,"Age Of Forays",0,4000,4000,2.99,0,66,1.01
"8129",8129,"B A S E M E N T",2000,4000,2000,0.99,100,0,0.99
"8130",8130,"Lu Bu Maker 여포키우기",0,4000,4000,7.99,0,0,7.99
"8131",8131,"War.io : Zombie Battle Royale",0,4000,4000,0.99,0,51,0.49
"8132",8132,"Hentai Neighbors",0,4000,4000,0.99,0,30,0.69
"8133",8133,"Unfinished - An Artist's Lament",2000,4000,2000,4.99,100,50,2.49
"8134",8134,"Psycho Squirrels",0,4000,4000,1.99,0,50,0.99
"8135",8135,"GRIDD: Retroenhanced",1000,4000,3000,11.99,300,50,5.99
"8136",8136,"Super Tits Rush",1000,4000,3000,0.99,300,51,0.49
"8137",8137,"Maitetsu",0,4000,4000,14.99,0,30,10.49
"8138",8138,"La Aventura De Axel",1000,4000,3000,1.99,300,75,0.49
"8139",8139,"3D Organon Anatomy",2000,4000,2000,24.99,100,50,12.49
"8140",8140,"The Prison Experiment: Battle Royale",1000,4000,3000,2.99,300,0,2.99
"8141",8141,"Infinity",0,4000,4000,4.99,0,33,3.34
"8142",8142,"darkcase : the basement",1000,4000,3000,1.99,300,75,0.49
"8143",8143,"Army Men",2000,4000,2000,5.99,100,50,2.99
"8144",8144,"Froggy BOI",1000,4000,3000,0.99,300,51,0.49
"8145",8145,"Rogue Empire: Dungeon Crawler RPG",2000,4000,2000,14.99,100,25,8.09
"8146",8146,"Animal couple",0,4000,4000,0.99,0,51,0.49
"8147",8147,"Alien Attack: Pocket Edition",0,4000,4000,0.99,0,40,0.59
"8148",8148,"Silver Creek Falls: Chapter 2",2000,4000,2000,4.99,100,40,2.99
"8149",8149,"EMMA The Story",1000,4000,3000,0.99,300,15,0.84
"8150",8150,"Galaxy Union",1000,4000,3000,4.99,300,15,4.24
"8151",8151,"Trivia Vault: Music Trivia",0,4000,4000,1.99,0,75,0.49
"8152",8152,"Adventure of a Lifetime",2000,4000,2000,12.99,100,25,9.74
"8153",8153,"PUZZLE: CATS & DOGS",0,4000,4000,1.99,0,75,0.49
"8154",8154,"Rabbit Story",2000,4000,2000,8.99,100,75,2.24
"8155",8155,"PAPA'S TIME MACHINE",1000,4000,3000,0.99,300,0,0.99
"8156",8156,"Bottle: Pilgrim",2000,4000,2000,5.99,100,35,3.89
"8157",8157,"Qbike: Cyberpunk Motorcycles",2000,4000,2000,9.99,100,65,3.49
"8158",8158,"Goblin Harvest - The Mighty Quest",1000,4000,3000,9.99,300,75,2.49
"8159",8159,"Sinister Zombies",2000,4000,2000,2.99,100,75,0.74
"8160",8160,"Type Defense",0,4000,4000,0.99,0,40,0.59
"8161",8161,"President Trump The Way In Uganda",1000,4000,3000,0.99,300,51,0.49
"8162",8162,"Immortals(修仙志)",0,4000,4000,3.99,0,20,3.19
"8163",8163,"This Is Not A Jumping Game",2000,4000,2000,3.99,100,50,1.99
"8164",8164,"SNIPER TANKS",0,4000,4000,0.99,0,51,0.49
"8165",8165,"Dissembler",1000,4000,3000,3.99,300,75,0.99
"8166",8166,"Dark SASI",1000,4000,3000,6.99,300,90,0.69
"8167",8167,"quadrant",2000,4000,2000,3.99,100,0,3.99
"8168",8168,"Psychopathics",2000,4000,2000,1.99,100,50,0.99
"8169",8169,"The Big Journey",2000,4000,2000,4.99,100,75,1.24
"8170",8170,"Splash Bash",2000,4000,2000,14.99,100,0,14.99
"8171",8171,"City Of Jade: Imperial Frontier",0,4000,4000,7.99,0,50,3.99
"8172",8172,"1000 Stages: The Hell",0,4000,4000,1.99,0,40,1.79
"8173",8173,"Quaddro 2",1000,4000,3000,1.99,300,40,1.19
"8174",8174,"Shoemaker",0,4000,4000,5.99,0,90,0.59
"8175",8175,"Eve of Destruction - REDUX VIETNAM",1000,4000,3000,9.99,300,25,7.49
"8176",8176,"TimeTekker",1000,4000,3000,0.99,300,45,0.54
"8177",8177,"This World Unknown",2000,4000,2000,7.99,100,50,3.99
"8178",8178,"Cute Cats PuZZles",0,4000,4000,0.99,0,51,0.49
"8179",8179,"STICKMAN BLAST",2000,4000,2000,0.99,100,51,0.49
"8180",8180,"The Monsters' History Book 怪物的历史书",0,4000,4000,3.99,0,25,2.33
"8181",8181,"Aborigenus",0,4000,4000,3.99,0,20,3.19
"8182",8182,"The Gardens Between",0,4000,4000,19.99,0,20,15.99
"8183",8183,"Arkasha",2000,4000,2000,0.99,100,51,0.49
"8184",8184,"Ceress and Orea",1000,4000,3000,1.99,300,50,0.99
"8185",8185,"True Fear: Forsaken Souls Part 2",0,4000,4000,9.99,0,10,8.99
"8186",8186,"Herald: An Interactive Period Drama - Book I & II",2000,4000,2000,9.99,100,30,6.99
"8187",8187,"Christmas Santa Troubles",0,4000,4000,0.99,0,51,0.49
"8188",8188,"DX-Ball 2: 20th Anniversary Edition",0,4000,4000,6.99,0,20,5.59
"8189",8189,"GORB",2000,4000,2000,0.99,100,51,0.49
"8190",8190,"Sarcophag",1000,4000,3000,0.99,300,40,0.59
"8191",8191,"Season Up",1000,4000,3000,1.99,300,75,0.49
"8192",8192,"Simon the Sorcerer: 25th Anniversary Edition",1000,4000,3000,4.99,300,0,4.99
"8193",8193,"The Deal",2000,4000,2000,6.99,100,90,0.69
"8194",8194,"The Breeding: The Fog",1000,4000,3000,4.99,300,80,0.99
"8195",8195,"Berry couple",0,4000,4000,0.99,0,51,0.49
"8196",8196,"Mio Garden",0,4000,4000,2.99,0,0,2.99
"8197",8197,"Count Dookie Fart",2000,4000,2000,0.99,100,0,0.99
"8198",8198,"OK/NORMAL",0,4000,4000,2.99,0,80,0.59
"8199",8199,"GRIS",0,4000,4000,16.99,0,0,16.99
"8200",8200,"Unmoor",2000,4000,2000,7.99,100,55,3.59
"8201",8201,"Princess Sahirah is a Spoiled Brat!",2000,4000,2000,2.99,100,83,0.5
"8202",8202,"Icky",2000,4000,2000,2.99,100,74,0.77
"8203",8203,"Football Girls: Dream Team",2000,4000,2000,6.99,100,65,2.44
"8204",8204,"The Strangers",0,4000,4000,1.99,0,60,0.79
"8205",8205,"8-in-1 IQ Scale Bundle",1000,4000,3000,14.99,300,75,3.74
"8206",8206,"Puzzle Sisters Foer",2000,4000,2000,0.99,100,51,0.49
"8207",8207,"Radiant One",0,4000,4000,4.99,0,50,2.49
"8208",8208,"NASCAR Heat 3",0,4000,4000,39.99,0,0,39.99
"8209",8209,"HotFloor",1000,4000,3000,4.99,300,80,0.99
"8210",8210,"Fly Destroyer",2000,4000,2000,0.99,100,51,0.49
"8211",8211,"Moral King",0,4000,4000,1.99,0,75,0.49
"8212",8212,"Solar Wind",1000,4000,3000,1.99,300,50,0.99
"8213",8213,"The Caribbean Sail",1000,4000,3000,11.99,300,50,5.99
"8214",8214,"Maze 4D",0,4000,4000,1.99,0,40,1.19
"8215",8215,"Professor Madhouse",2000,4000,2000,1.99,100,20,1.59
"8216",8216,"Grave: VR Prologue",2000,4000,2000,7.99,100,0,7.99
"8217",8217,"Rumu",2000,4000,2000,9.99,100,50,9.99
"8218",8218,"Sudoku Killer / 杀手数独",0,4000,4000,1.99,0,30,1.39
"8219",8219,"7-in-1 Brain Sharpness Bundle",2000,4000,2000,12.99,100,75,3.24
"8220",8220,"KURSK",0,4000,4000,29.99,0,15,25.49
"8221",8221,"Lord VS Nas Vai",0,4000,4000,0.99,0,51,0.49
"8222",8222,"Alone",0,4000,4000,0.99,0,25,0.74
"8223",8223,"My Big Sister",1000,4000,3000,5.99,300,33,4.01
"8224",8224,"Bullet Witch",2000,4000,2000,14.99,100,50,7.49
"8225",8225,"ArcBall 2",2000,4000,2000,0.99,100,51,0.49
"8226",8226,"Freddy's Journey",0,4000,4000,1.99,0,55,0.89
"8227",8227,"Operation Apex",2000,4000,2000,9.99,100,50,4.99
"8228",8228,"VR Mini Bowling",2000,4000,2000,4.99,100,40,2.99
"8229",8229,"The Sorceress",2000,4000,2000,4.99,100,50,2.49
"8230",8230,"Love Games",0,4000,4000,1.99,0,30,1.39
"8231",8231,"Space Simulator",2000,4000,2000,9.99,100,20,7.99
"8232",8232,"Evocation",0,4000,4000,1.99,0,50,1.99
"8233",8233,"Crushing Blow",2000,4000,2000,1.99,100,70,0.59
"8234",8234,"Next Hero",1000,4000,3000,9.99,300,40,5.99
"8235",8235,"Romance of the Three Kingdoms　VII with Power Up Kit / 三國志VII with パワーアップキット",2000,4000,2000,19.99,100,30,13.99
"8236",8236,"Night Magic",0,4000,4000,3.99,0,87,0.51
"8237",8237,"Hellenica",2000,4000,2000,9.99,100,75,4.99
"8238",8238,"Beasts&Chests",0,4000,4000,0.99,0,51,0.49
"8239",8239,"Leviathan ~A Survival RPG~",0,4000,4000,9.99,0,15,8.49
"8240",8240,"Permission VR",0,4000,4000,2.99,0,0,2.99
"8241",8241,"ASCII Game Series: Snake",2000,4000,2000,0.99,100,51,0.49
"8242",8242,"The Last One",2000,4000,2000,8.99,100,60,3.59
"8243",8243,"EduNumbers",0,4000,4000,14.99,0,50,7.49
"8244",8244,"Trawl",1000,4000,3000,6.99,300,87,0.9
"8245",8245,"Downhill Deceits",1000,4000,3000,0.99,300,51,0.49
"8246",8246,"Re Angel",2000,4000,2000,15.99,100,0,15.99
"8247",8247,"Dangerous Ground",0,4000,4000,0.99,0,40,0.59
"8248",8248,"Nights at the Clown Maze",0,4000,4000,1.99,0,0,1.99
"8249",8249,"Wall Walker",0,4000,4000,9.99,0,20,7.99
"8250",8250,"Fear the Night",0,4000,4000,14.99,0,25,11.24
"8251",8251,"Code World",2000,4000,2000,4.99,100,70,1.49
"8252",8252,"Trials of the Illuminati: Cityscape Animated Jigsaws",1000,4000,3000,1.99,300,75,0.49
"8253",8253,"AWS Argentina Wingshooting Simulator",2000,4000,2000,3.99,100,50,1.99
"8254",8254,"Star Fleet Armada Rogue Adventures",1000,4000,3000,6.99,300,50,4.89
"8255",8255,"Age of Fear 3: The Legend",2000,4000,2000,24.99,100,50,12.49
"8256",8256,"Vegetable couple",0,4000,4000,0.99,0,51,0.49
"8257",8257,"Call each NEW YEAR",0,4000,4000,0.99,0,75,0.49
"8258",8258,"Stickman.io",2000,4000,2000,3.99,100,87,0.51
"8259",8259,"Pestis",2000,4000,2000,1.99,100,70,0.59
"8260",8260,"BoxMaker",2000,4000,2000,5.99,100,0,5.99
"8261",8261,"Learn Japanese To Survive! Kanji Combat",0,4000,4000,8.99,0,30,6.29
"8262",8262,"Piopupu",2000,4000,2000,1.99,100,40,1.19
"8263",8263,"Magic Siege - Defender",2000,4000,2000,2.99,100,80,0.59
"8264",8264,"Light House Puzzle",0,4000,4000,0.99,0,40,0.59
"8265",8265,"Bubsy: The Woolies Strike Back",2000,4000,2000,19.99,100,75,4.99
"8266",8266,"Rockland VR",1000,4000,3000,3.99,300,40,2.39
"8267",8267,"Pitch Perfect Ear Training",0,4000,4000,4.99,0,0,4.99
"8268",8268,"DrillMania",0,4000,4000,1.99,0,20,1.59
"8269",8269,"Massive Assault",1000,4000,3000,9.99,300,75,2.49
"8270",8270,"Riverhill Trials",1000,4000,3000,0.99,300,75,0.49
"8271",8271,"Make a word!",2000,4000,2000,1.99,100,75,0.49
"8272",8272,"Deathlike: Awakening",2000,4000,2000,9.99,100,50,4.99
"8273",8273,"Tvori",2000,4000,2000,19.99,100,50,9.99
"8274",8274,"Mariko: Hot Nightlife",2000,4000,2000,1.99,100,60,0.79
"8275",8275,"ASCII Achievement Mania: Space Shooter",2000,4000,2000,0.99,100,51,0.49
"8276",8276,"DON'T touch the walls",2000,4000,2000,0.99,100,0,0.99
"8277",8277,"Le Havre: The Inland Port",2000,4000,2000,9.99,100,57,3
"8278",8278,"FORCE TANKS",2000,4000,2000,1.99,100,75,0.49
"8279",8279,"Cube Defender 2000",0,4000,4000,0.99,0,0,0.99
"8280",8280,"Venture Arctic",0,4000,4000,1.99,0,50,0.99
"8281",8281,"The Labyrinth of Time",2000,4000,2000,5.99,100,80,1.19
"8282",8282,"Which Way Out",0,4000,4000,0.99,0,51,0.49
"8283",8283,"Rescale",0,4000,4000,0.99,0,0,0.99
"8284",8284,"Witch of the Woods",0,4000,4000,2.99,0,0,2.99
"8285",8285,"VALIANT KNIGHTS Typing Battle",1000,4000,3000,9.99,300,60,3.99
"8286",8286,"Nusantara: Legend of The Winged Ones",0,4000,4000,4.99,0,20,3.99
"8287",8287,"Tennis Elbow Manager",2000,4000,2000,19.99,100,75,4.99
"8288",8288,"Common Hanzi Quiz - Simplified Chinese",0,4000,4000,2.99,0,0,2.99
"8289",8289,"Digital Jigsaw Puzzle",0,4000,4000,4.99,0,50,2.49
"8290",8290,"Animals Memory: Horses",0,4000,4000,0.99,0,45,0.54
"8291",8291,"JIN LIN LOVE STORY 《我記憶中的金鱗物語》",0,4000,4000,3.99,0,10,3.59
"8292",8292,"Antirocketh",0,4000,4000,1.99,0,60,0.79
"8293",8293,"Spiritlands",2000,4000,2000,6.99,100,70,2.09
"8294",8294,"Again?",0,4000,4000,0.99,0,45,0.54
"8295",8295,"Drink Pro Tycoon",2000,4000,2000,9.99,100,80,1.99
"8296",8296,"ButcherBoy",0,4000,4000,0.99,0,51,0.49
"8297",8297,"RUGBY 18",2000,4000,2000,39.99,100,70,11.99
"8298",8298,"Elections Simulator 2018",1000,4000,3000,0.99,300,51,0.49
"8299",8299,"Spears 'n' Spades",2000,4000,2000,1.99,100,0,1.99
"8300",8300,"Limelight VR",1000,4000,3000,7.99,300,0,7.99
"8301",8301,"National Rugby Manager",1000,4000,3000,18.99,300,50,9.49
"8302",8302,"Crafting Dead",2000,4000,2000,9.99,100,0,9.99
"8303",8303,"SPEED BOX",0,4000,4000,0.99,0,51,0.49
"8304",8304,"DYNASTY WARRIORS 7: Xtreme Legends Definitive Edition / 真・三國無双６ with 猛将伝 DX",0,4000,4000,19.99,0,10,17.99
"8305",8305,"Deadly Dozen",1000,4000,3000,9.99,300,80,1.99
"8306",8306,"Asterix & Obelix XXL 2",0,4000,4000,29.99,0,10,26.99
"8307",8307,"Solitaire: Learn the Flags!",0,4000,4000,1.99,0,25,1.49
"8308",8308,"Kingdom: The Far Reaches",1000,4000,3000,9.99,300,66,3.39
"8309",8309,"Mono",2000,4000,2000,3.99,100,65,1.39
"8310",8310,"Samozbor: Rebellion",0,4000,4000,0.99,0,15,0.84
"8311",8311,"PAPER FRONT",0,4000,4000,0.99,0,51,0.49
"8312",8312,"Deadhunt",2000,4000,2000,4.99,100,30,3.49
"8313",8313,"Gas Guzzlers: Combat Carnage",2000,4000,2000,4.99,100,40,2.99
"8314",8314,"Let's Split Up (A Visual Novel)",0,4000,4000,1.99,0,75,0.99
"8315",8315,"Hyperspeed",1000,4000,3000,6.99,300,75,1.74
"8316",8316,"DEADLY WHEELS",0,4000,4000,1.99,0,75,0.49
"8317",8317,"Floor Massacre",0,4000,4000,0.99,0,51,0.49
"8318",8318,"Tony Tough and the Night of Roasted Moths",1000,4000,3000,9.99,300,80,1.99
"8319",8319,"Zak McKracken and the Alien Mindbenders",0,4000,4000,5.99,0,40,3.59
"8320",8320,"L.S.S",2000,4000,2000,0.99,100,20,0.79
"8321",8321,"EBOLA.VI.CORP",0,3000,3000,0.99,0,35,0.64
"8322",8322,"Pirates of corsairs",0,3000,3000,1,0,30,0.7
"8323",8323,"The Operational Art of War IV",0,3000,3000,39.99,0,25,29.99
"8324",8324,"qrth-phyl",0,3000,3000,4.99,0,20,3.99
"8325",8325,"Border Of Insanity",0,3000,3000,3.99,0,87,0.51
"8326",8326,"THE AWKWARD STEVE DUOLOGY",1000,3000,2000,3.99,200,40,2.39
"8327",8327,"The Best Of MagiCats",1000,3000,2000,9.99,200,75,2.49
"8328",8328,"Medieval Survival",0,3000,3000,3.99,0,87,0.51
"8329",8329,"秘封ナイトメアダイアリー ～ Violet Detector.",0,3000,3000,10.99,0,0,10.99
"8330",8330,"Preta: Vendetta Rising",1000,3000,2000,19.99,200,20,15.99
"8331",8331,"Combat Tested",1000,3000,2000,19.99,200,50,9.99
"8332",8332,"In The Fighting",0,3000,3000,0.99,0,51,0.49
"8333",8333,"Valerian Tales",0,3000,3000,8.99,0,0,8.99
"8334",8334,"Spotter",0,3000,3000,4.99,0,0,4.99
"8335",8335,"Switchblade",0,3000,3000,2.99,0,20,2.99
"8336",8336,"Blockz VS Ballz",0,3000,3000,0.99,0,51,0.49
"8337",8337,"Ocean's Treasures",0,3000,3000,4.99,0,0,4.99
"8338",8338,"Fly of Butterfly",0,3000,3000,1.99,0,34,1.31
"8339",8339,"Zhmyshenko Valery Albertovich",1000,3000,2000,0.99,200,51,0.49
"8340",8340,"Drugs to Bee",0,3000,3000,0.99,0,51,0.49
"8341",8341,"Checkmate!",0,3000,3000,1.99,0,30,1.39
"8342",8342,"GraviSound",0,3000,3000,1.29,0,62,0.49
"8343",8343,"King Of Gods: Angel The Awakening Of A Demon",0,3000,3000,4.99,0,0,4.99
"8344",8344,"The Frosty Leaves 寒叶下的薄冰",1000,3000,2000,0.99,200,51,0.49
"8345",8345,"Pizza Connection",1000,3000,2000,5.99,200,75,1.49
"8346",8346,"TheNightfall",1000,3000,2000,24.99,200,50,12.49
"8347",8347,"Ball Driver",1000,3000,2000,0.99,200,51,0.49
"8348",8348,"EW/WE",0,3000,3000,0.99,0,0,0.99
"8349",8349,"Hell Shooter",0,3000,3000,0.99,0,20,0.79
"8350",8350,"SCREW-NUT",1000,3000,2000,0.99,200,51,0.49
"8351",8351,"WatchFamily",0,3000,3000,0.99,0,20,0.79
"8352",8352,"Yahrit!",0,3000,3000,2.99,0,50,1.49
"8353",8353,"E.Z",1000,3000,2000,1.99,200,50,0.99
"8354",8354,"GEO Master",1000,3000,2000,2.99,200,0,2.99
"8355",8355,"Deadly Stigma",0,3000,3000,1.99,0,50,0.99
"8356",8356,"Firebird - The Unfinished",1000,3000,2000,4.99,200,50,2.49
"8357",8357,"Viki Spotter: School",1000,3000,2000,1.99,200,75,0.49
"8358",8358,"The Last Train",0,3000,3000,9.99,0,20,7.99
"8359",8359,"Slither Link",0,3000,3000,0.99,0,0,0.99
"8360",8360,"The Watchmaker",1000,3000,2000,14.99,200,70,4.49
"8361",8361,"Horse World",1000,3000,2000,9.99,200,60,3.99
"8362",8362,"My Grandfather's Farm",0,3000,3000,14.99,0,50,7.49
"8363",8363,"Pirate Mosaic Puzzle. Caribbean Treasures",0,3000,3000,4.99,0,90,0.49
"8364",8364,"Unexpected Journey 奇幻之旅",0,3000,3000,1.99,0,30,1.39
"8365",8365,"RAZED",0,3000,3000,11.99,0,40,7.19
"8366",8366,"Vive le Roi 2",0,3000,3000,3.99,0,70,1.19
"8367",8367,"The Cat and the Coup (4K Remaster)",0,3000,3000,1.99,0,75,0.49
"8368",8368,"Pinball 2018",1000,3000,2000,1.99,200,75,0.49
"8369",8369,"Dungeon Deathball",0,3000,3000,7.99,0,20,4.24
"8370",8370,"Greece Defense TD",1000,3000,2000,3.99,200,75,0.99
"8371",8371,"Fantasy Farming: Orange Season",1000,3000,2000,13.99,200,30,9.79
"8372",8372,"Anime Girl Or Boy?",0,3000,3000,0.99,0,51,0.49
"8373",8373,"Outrealm",1000,3000,2000,8.99,200,30,6.29
"8374",8374,"Zero spring episode 1 Japanese version",0,3000,3000,0.99,0,0,0.99
"8375",8375,"One Watcher",1000,3000,2000,3.99,200,75,1.99
"8376",8376,"Stickman in the Portal",0,3000,3000,0.99,0,51,0.49
"8377",8377,"Koihime Enbu RyoRaiRai 恋姫†演武 ～遼来来～",0,3000,3000,19.99,0,20,15.99
"8378",8378,"Furious Seas",0,3000,3000,19.99,0,30,13.99
"8379",8379,"Mugsters",0,3000,3000,14.99,0,50,7.49
"8380",8380,"Greenspawn Restaurant",0,3000,3000,2.99,0,70,0.89
"8381",8381,"Learn (Japanese) Kana The Fun Way!",1000,3000,2000,4.99,200,70,1.49
"8382",8382,"Hentai Shooter 3D: Christmas Party",0,3000,3000,1.99,0,75,0.49
"8383",8383,"Newton and the Apple Tree",0,3000,3000,39.99,0,15,33.99
"8384",8384,"Beyond Minimalism",0,3000,3000,3.99,0,87,0.51
"8385",8385,"Mummy on the run",0,3000,3000,7.99,0,25,5.99
"8386",8386,"Space Bugs",0,3000,3000,1.99,0,50,0.99
"8387",8387,"BIG POGO MAN",0,3000,3000,4.99,0,60,1.99
"8388",8388,"Cinderella VR",0,3000,3000,9.99,0,0,9.99
"8389",8389,"FIGHTING EX LAYER",0,3000,3000,39.99,0,26,29.59
"8390",8390,"The 25th Ward: The Silver Case / シルバー事件２５区",1000,3000,2000,29.99,200,50,14.99
"8391",8391,"Zombie Desperation",1000,3000,2000,0.99,200,51,0.49
"8392",8392,"Space Guard",0,3000,3000,0.99,0,40,0.59
"8393",8393,"Defense of the Fantasy Robots",0,3000,3000,7.99,0,25,5.99
"8394",8394,"Shadow Mist",1000,3000,2000,4.99,200,0,4.99
"8395",8395,"The Road to Hades",1000,3000,2000,14.99,200,80,2.99
"8396",8396,"I saw IT",1000,3000,2000,0.99,200,51,0.49
"8397",8397,"Free the Animation",0,3000,3000,2.99,0,50,2.49
"8398",8398,"Demon's Rise - War for the Deep",1000,3000,2000,6.99,200,50,3.49
"8399",8399,"Baby's on fire: 99 virgins",1000,3000,2000,0.99,200,51,0.49
"8400",8400,"Totally Mayhem",1000,3000,2000,2.99,200,83,0.5
"8401",8401,"Vadine: Bite-Man",0,3000,3000,1.99,0,33,1.33
"8402",8402,"Yanone: Letter Splatter",1000,3000,2000,0.99,200,10,0.89
"8403",8403,"Nubs' Adventure",1000,3000,2000,6.99,200,80,1.39
"8404",8404,"Super Ledgehop: Double Laser",0,3000,3000,0.99,0,10,0.89
"8405",8405,"Werewolves: Haven Rising",0,3000,3000,5.99,0,35,3.89
"8406",8406,"The Unknown City (Horror Begins Now.....Episode 1)",0,3000,3000,9.99,0,90,0.99
"8407",8407,"Kingpin Royale",0,3000,3000,9.99,0,10,8.99
"8408",8408,"Girls Dance",0,3000,3000,1.99,0,20,1.59
"8409",8409,"Soul for two",1000,3000,2000,0.99,200,45,0.54
"8410",8410,"The Word Is Not The Thing",0,3000,3000,1.99,0,0,1.99
"8411",8411,"Tower Fortress",1000,3000,2000,4.99,200,30,3.49
"8412",8412,"Tanking Tanks",0,3000,3000,0.99,0,40,0.59
"8413",8413,"Crossroad",1000,3000,2000,8.99,200,61,3.5
"8414",8414,"Super Steampunk Pinball 2D",1000,3000,2000,1.99,200,40,1.19
"8415",8415,"IRO HERO",0,3000,3000,9.99,0,33,6.69
"8416",8416,"Tell Me Everything",1000,3000,2000,0.99,200,51,0.49
"8417",8417,"Ball run and rush",0,3000,3000,3.99,0,46,3.99
"8418",8418,"Umiro",1000,3000,2000,2.99,200,50,1.49
"8419",8419,"The Last DeadEnd",1000,3000,2000,7.99,200,25,5.99
"8420",8420,"Space Drift Squad",0,3000,3000,2.99,0,60,1.19
"8421",8421,"Urban - Episode 1",0,3000,3000,9.99,0,90,0.99
"8422",8422,"Mary Le Chef - Cooking Passion",1000,3000,2000,12.99,200,50,6.49
"8423",8423,"Muay Thai Fighting",0,3000,3000,6.99,0,50,3.49
"8424",8424,"The Naked Game",1000,3000,2000,9.99,200,75,3.74
"8425",8425,"X-ray hospital",1000,3000,2000,1.99,200,50,0.99
"8426",8426,"Bouncing Over It with friends",0,3000,3000,4.99,0,70,1.49
"8427",8427,"Project GR-5LYR: Galactic Relocation",0,3000,3000,4.99,0,0,4.99
"8428",8428,"Total 15",0,3000,3000,0.99,0,40,0.74
"8429",8429,"Yokai Mask",0,3000,3000,1.99,0,50,0.99
"8430",8430,"Match Connect Challenge",0,3000,3000,1.99,0,65,0.69
"8431",8431,"Hectic",0,3000,3000,4.99,0,20,3.99
"8432",8432,"Dead Ground",1000,3000,2000,4.99,200,90,0.49
"8433",8433,"Heaven Will Be Mine",0,3000,3000,14.99,0,15,12.74
"8434",8434,"MAGIX Music Maker 2016 Live",1000,3000,2000,69.99,200,80,13.99
"8435",8435,"The Promethium Effect - The Idle Clicker MMO",1000,3000,2000,1.29,200,0,1.29
"8436",8436,"Space Jump Cat",0,3000,3000,0.99,0,0,0.99
"8437",8437,"Leveron Space",1000,3000,2000,0.99,200,0,0.99
"8438",8438,"Tempo Wizard",0,3000,3000,0.99,0,45,0.54
"8439",8439,"Keep Watching VR",1000,3000,2000,2.99,200,0,2.99
"8440",8440,"Magic matchstick",1000,3000,2000,0.99,200,51,0.49
"8441",8441,"Gallows Choice",0,3000,3000,1.99,0,30,1.39
"8442",8442,"Fish Catcher",0,3000,3000,0.99,0,40,0.59
"8443",8443,"Lost in Vivo",0,3000,3000,11.99,0,17,9.95
"8444",8444,"幻想三國誌5/Fantasia Sango 5",0,3000,3000,29.99,0,35,19.49
"8445",8445,"Foto Flash 2",0,3000,3000,2.99,0,25,2.24
"8446",8446,"Tank of War-VR",1000,3000,2000,19.99,200,70,5.99
"8447",8447,"THE GREY MAN",1000,3000,2000,6.99,200,80,1.39
"8448",8448,"Jumponaut",0,3000,3000,2.99,0,70,0.89
"8449",8449,"Motorhead",1000,3000,2000,4.99,200,0,4.99
"8450",8450,"Chef: A Restaurant Tycoon Game",0,3000,3000,19.99,0,10,17.99
"8451",8451,"Ants! Mission of the salvation",1000,3000,2000,1.99,200,60,0.79
"8452",8452,"Chicken in the Darkness",0,3000,3000,2.49,0,0,2.49
"8453",8453,"Rise up",0,3000,3000,0.99,0,51,0.49
"8454",8454,"Trooper 2 - Alien Justice",0,3000,3000,3.99,0,50,1.99
"8455",8455,"Too Many Weapons",1000,3000,2000,9.99,200,90,0.99
"8456",8456,"Neptune Flux",1000,3000,2000,7.99,200,50,3.99
"8457",8457,"Baobabs Mausoleum Ep. 2: 1313 Barnabas Dead End Drive",1000,3000,2000,5.99,200,40,3.59
"8458",8458,"Shape of the World",1000,3000,2000,12.99,200,25,9.74
"8459",8459,"Drunk Puppet",0,3000,3000,4.99,0,80,0.99
"8460",8460,"My Bingo",0,3000,3000,0.99,0,51,0.49
"8461",8461,"Z-End",1000,3000,2000,3.99,200,50,1.99
"8462",8462,"WHERE'S PHANTOM THIEF",0,3000,3000,7.99,0,50,3.99
"8463",8463,"Gray Skies, Dark Waters",1000,3000,2000,4.99,200,50,3.34
"8464",8464,"My Brother Rabbit",0,3000,3000,14.99,0,20,11.99
"8465",8465,"Alchemia",0,3000,3000,1.99,0,10,1.79
"8466",8466,"Lawnmower Game 3: Horror",0,3000,3000,1.99,0,75,0.49
"8467",8467,"Outer Space",0,3000,3000,0.99,0,51,0.49
"8468",8468,"The Adventure of Magical Girl",0,3000,3000,2.99,0,50,1.49
"8469",8469,"ARK -the lost fairytale-",0,3000,3000,2.99,0,30,2.09
"8470",8470,"Pivot XL",1000,3000,2000,0.99,200,51,0.49
"8471",8471,"Cat's Yarn",0,3000,3000,2.99,0,0,2.99
"8472",8472,"魔塔2018",0,3000,3000,1.99,0,28,1.43
"8473",8473,"Chill Out",0,3000,3000,0.99,0,51,0.49
"8474",8474,"Fatal Stormer",1000,3000,2000,9.99,200,75,2.49
"8475",8475,"Queen Of Thieves",1000,3000,2000,24.99,200,50,12.49
"8476",8476,"It's You: A Breakup Story",0,3000,3000,4.99,0,15,4.24
"8477",8477,"Taekwondo Grand Prix",0,3000,3000,9.99,0,25,7.49
"8478",8478,"Starship Clicker",1000,3000,2000,0.99,200,51,0.49
"8479",8479,"Sci-fi Chess",1000,3000,2000,0.99,200,51,0.49
"8480",8480,"Volotic",1000,3000,2000,9.99,200,50,4.99
"8481",8481,"PROTEST",0,3000,3000,1.99,0,40,1.19
"8482",8482,"Deconstructor",0,3000,3000,1.99,0,75,0.49
"8483",8483,"Rimi Action RPG",0,3000,3000,0.99,0,51,0.49
"8484",8484,"Escape From Tethys",0,3000,3000,4.99,0,30,3.49
"8485",8485,"Beachhead: DESERT WAR",1000,3000,2000,1.99,200,0,1.99
"8486",8486,"Mars Troopers",0,3000,3000,5.99,0,85,0.89
"8487",8487,"Viking Days",0,3000,3000,4.99,0,70,1.49
"8488",8488,"Mesel",1000,3000,2000,4.99,200,20,3.99
"8489",8489,"Torsion",1000,3000,2000,1.99,200,0,1.99
"8490",8490,"POSTWORLD",0,3000,3000,15,0,15,15
"8491",8491,"Goblins on Alien Planet",0,3000,3000,0.99,0,51,0.49
"8492",8492,"FlappyU VR",0,3000,3000,1.99,0,20,1.59
"8493",8493,"RAMS",0,3000,3000,12.99,0,10,11.69
"8494",8494,"Truth Of Falchion",1000,3000,2000,1.99,200,60,0.49
"8495",8495,"Dojini",0,3000,3000,0.99,0,65,1.04
"8496",8496,"Super Plumber",0,3000,3000,2.99,0,83,0.5
"8497",8497,"Panacea: Last Will",1000,3000,2000,7.99,200,50,3.99
"8498",8498,"Space Force",1000,3000,2000,1.99,200,50,0.99
"8499",8499,"Disneyland Adventures",0,3000,3000,19.99,0,25,14.99
"8500",8500,"Memory Trainer",0,3000,3000,0.99,0,51,0.49
"8501",8501,"Yet another tower defence",0,3000,3000,1.99,0,40,1.19
"8502",8502,"Attack Helicopter Dating Simulator",0,3000,3000,9.99,0,0,9.99
"8503",8503,"Lily's Night Off",0,3000,3000,3.99,0,63,2.95
"8504",8504,"Waterside Chirping 水畔空蝉",0,3000,3000,0.99,0,51,0.49
"8505",8505,"Puzzle Monarch: Super Natural",0,3000,3000,0.99,0,51,0.49
"8506",8506,"Dark Ghost RPG",1000,3000,2000,5.99,200,90,0.59
"8507",8507,"Dragon`s Checkers",0,3000,3000,0.99,0,40,0.59
"8508",8508,"Containment Initiative: PC Standalone",1000,3000,2000,0.99,200,40,0.59
"8509",8509,"Save President From Rebels",0,3000,3000,0.99,0,51,0.49
"8510",8510,"Clatter",0,3000,3000,9.99,0,20,7.99
"8511",8511,"Dust and Salt",1000,3000,2000,7.99,200,50,3.99
"8512",8512,"Fighting Fantasy Legends Portal",0,3000,3000,9.99,0,60,3.99
"8513",8513,"Point",1000,3000,2000,0.99,200,0,0.99
"8514",8514,"Poverty is a Choice",0,3000,3000,11.99,0,15,10.19
"8515",8515,"Volume Maximizer",1000,3000,2000,7.99,200,75,1.99
"8516",8516,"Excursion",0,3000,3000,2.99,0,83,0.84
"8517",8517,"King of Phoenix",0,3000,3000,2.99,0,10,2.69
"8518",8518,"The Ninja Path",0,3000,3000,0.99,0,51,0.49
"8519",8519,"The Odd Battle",0,3000,3000,3.99,0,50,1.99
"8520",8520,"aMAZEing adventures",1000,3000,2000,3.99,200,75,0.99
"8521",8521,"Black Hangman",0,3000,3000,0.99,0,40,0.59
"8522",8522,"Awkward Date Hero",0,3000,3000,1.99,0,0,1.99
"8523",8523,"Tower climber",1000,3000,2000,0.99,200,51,0.49
"8524",8524,"Fitzzle Adorable Puppies",0,3000,3000,2.99,0,80,0.59
"8525",8525,"Escape: Close Call",1000,3000,2000,6.99,200,0,6.99
"8526",8526,"I Am Overburdened",1000,3000,2000,4.99,200,40,2.99
"8527",8527,"Z.W!",1000,3000,2000,0.99,200,51,0.49
"8528",8528,"Dinosaur Hunter VR",0,3000,3000,2.99,0,50,1.49
"8529",8529,"Steam Tactics",1000,3000,2000,9.99,200,80,1.99
"8530",8530,"Prehistoria",0,3000,3000,2.99,0,50,1.49
"8531",8531,"Cat's Puzzle /ᐠ｡ꞈ｡ᐟ\",0,3000,3000,0.99,0,51,0.49
"8532",8532,"RollTheEarth",0,3000,3000,1.99,0,77,0.91
"8533",8533,"Pleasure Puzzle:Sexy Girls",0,3000,3000,0.99,0,30,0.69
"8534",8534,"HOLONGLIDE",0,3000,3000,2.99,0,0,0.99
"8535",8535,"Summer Memory of Bell 忆夏之铃",0,3000,3000,2.99,0,30,2.09
"8536",8536,"HEROES TRIALS",0,3000,3000,5.99,0,0,5.99
"8537",8537,"Paris: Jigsaw Puzzles",1000,3000,2000,1.99,200,60,0.79
"8538",8538,"Romance of the Three Kingdoms　VI with Power Up Kit / 三國志VI with パワーアップキット",1000,3000,2000,19.99,200,30,13.99
"8539",8539,"Mahjong Match",1000,3000,2000,2.99,200,70,0.89
"8540",8540,"Uventa",0,3000,3000,5.99,0,40,3.59
"8541",8541,"Navalny: Posledniy miting",0,3000,3000,0.99,0,0,0.99
"8542",8542,"Unreal Estate",1000,3000,2000,2.99,200,50,1.49
"8543",8543,"The Works of Mercy",0,3000,3000,14.99,0,50,7.49
"8544",8544,"Seul (Alone): The entrée",0,3000,3000,2.99,0,20,2.39
"8545",8545,"Lazaretto",1000,3000,2000,6.99,200,55,3.14
"8546",8546,"Aliens Are Rude!",0,3000,3000,1.99,0,50,0.99
"8547",8547,"Umfend",0,3000,3000,4.99,0,10,4.49
"8548",8548,"Boiling Bolt",1000,3000,2000,11.99,200,40,7.19
"8549",8549,"The Eerie Inn",1000,3000,2000,4.99,200,50,2.49
"8550",8550,"OtterBash",1000,3000,2000,9.99,200,0,9.99
"8551",8551,"Last Encounter",1000,3000,2000,14.99,200,34,9.89
"8552",8552,"Star Valor",0,3000,3000,10.99,0,30,7.69
"8553",8553,"Magnetic Pairs",1000,3000,2000,1.99,200,75,0.49
"8554",8554,"ROLL!",0,3000,3000,0.99,0,15,0.84
"8555",8555,"Rival Megagun",0,3000,3000,14.99,0,0,14.99
"8556",8556,"FACE",1000,3000,2000,0.99,200,51,0.49
"8557",8557,"21",0,3000,3000,0.99,0,40,0.59
"8558",8558,"Amber's Magic Shop",1000,3000,2000,19.99,200,35,12.99
"8559",8559,"Ales Dash",0,3000,3000,2.99,0,67,0.98
"8560",8560,"Recreational Dreaming",1000,3000,2000,5.99,200,0,5.99
"8561",8561,"Ghoststory",0,3000,3000,9.99,0,90,0.99
"8562",8562,"Dance With Memes",1000,3000,2000,1.99,200,20,1.59
"8563",8563,"Cat Fu Mi",0,3000,3000,1.99,0,60,0.79
"8564",8564,"HellMaze",0,3000,3000,4.99,0,0,4.99
"8565",8565,"Tower Defense > Red Rose Rising",0,3000,3000,2.99,0,0,2.99
"8566",8566,"Royal Adventure",1000,3000,2000,6.99,200,65,2.44
"8567",8567,"Fate Hunters",0,3000,3000,14.99,0,25,11.24
"8568",8568,"God's Basement",0,3000,3000,14.99,0,20,11.99
"8569",8569,"Fallen Bird",1000,3000,2000,4.99,200,50,2.49
"8570",8570,"Castle of Venia",0,3000,3000,2.99,0,83,0.5
"8571",8571,"Space God",1000,3000,2000,4.99,200,80,0.99
"8572",8572,"Galencia",0,3000,3000,2.99,0,40,1.79
"8573",8573,"Wolf Gang",1000,3000,2000,14.99,200,50,7.49
"8574",8574,"Sounds of Verity",1000,3000,2000,4.99,200,80,1.39
"8575",8575,"Viral",1000,3000,2000,0.99,200,0,0.99
"8576",8576,"Tap & Clapp",0,3000,3000,0.99,0,51,0.49
"8577",8577,"School of Horror",0,3000,3000,1.99,0,75,0.49
"8578",8578,"Rat Arena",0,3000,3000,0.99,0,51,0.49
"8579",8579,"From The Sky: New Horizon",0,3000,3000,0.99,0,51,0.49
"8580",8580,"无敌荒野/Unbeatable wilderness",0,3000,3000,2.99,0,65,1.04
"8581",8581,"NIGHT FALLEN",0,3000,3000,1.99,0,25,1.99
"8582",8582,"Clumsy Knight",1000,3000,2000,2.99,200,75,0.74
"8583",8583,"Prototype TD",0,3000,3000,1.99,0,0,1.99
"8584",8584,"7 Days in Dream 光尘",1000,3000,2000,2.99,200,50,1.49
"8585",8585,"HenTris",0,3000,3000,0.99,0,51,0.49
"8586",8586,"Devastator Arena",0,3000,3000,3.99,0,87,0.51
"8587",8587,"Retro Snake",0,3000,3000,1.99,0,75,0.49
"8588",8588,"Bean Battles",0,3000,3000,2.99,0,50,1.49
"8589",8589,"Shallow Swing",0,3000,3000,4.99,0,40,2.99
"8590",8590,"Hentai Strip Shot",0,3000,3000,1.99,0,30,1.39
"8591",8591,"初颜 - The Prototype",1000,3000,2000,11.99,200,0,11.99
"8592",8592,"PlatONIR",0,3000,3000,0.99,0,51,0.49
"8593",8593,"秋叶|Autumn leaves",0,3000,3000,0.99,0,30,0.69
"8594",8594,"Coinon",0,3000,3000,10.99,0,70,3.29
"8595",8595,"SIG",0,3000,3000,0.99,0,51,0.49
"8596",8596,"Hailey",0,3000,3000,2.99,0,0,2.99
"8597",8597,"Jewel of WonderLand",0,3000,3000,3.99,0,70,1.19
"8598",8598,"Battle Of Worldviews",0,3000,3000,1.99,0,75,0.49
"8599",8599,"Sky Ball",1000,3000,2000,2.99,200,80,0.59
"8600",8600,"Fluffy Horde",0,3000,3000,9.99,0,15,8.49
"8601",8601,"Girl with a big SWORD",0,3000,3000,0.99,0,25,0.74
"8602",8602,"Shepard Fairey VR - DAMAGED",0,3000,3000,4.99,0,0,4.99
"8603",8603,"Zombie Builder Defense",0,3000,3000,1.99,0,0,1.99
"8604",8604,"Lamp Man Down",0,3000,3000,0.99,0,0,0.99
"8605",8605,"R-COIL",1000,3000,2000,4.99,200,90,0.49
"8606",8606,"Space Ranger vs. Reptiloids: 2 Edition",0,3000,3000,0.99,0,51,0.49
"8607",8607,"HellStar Squadron",1000,3000,2000,1.99,200,75,0.49
"8608",8608,"Cool Dragon",0,3000,3000,3.99,0,87,0.51
"8609",8609,"Fei Duanmu VS Kobayashi 端木斐 VS 小林正雪",0,3000,3000,5.99,0,10,5.39
"8610",8610,"Tiny-Tasy Town",0,3000,3000,11.99,0,30,8.39
"8611",8611,"Frontline Heroes VR",1000,3000,2000,4.99,200,50,2.49
"8612",8612,"Smile'N'Slide",0,3000,3000,1.99,0,60,0.79
"8613",8613,"5 Star Hawaii Resort - Your Resort",1000,3000,2000,8.99,200,70,2.69
"8614",8614,"I'm Lost",1000,3000,2000,0.99,200,33,0.66
"8615",8615,"Heaven & Hell",0,3000,3000,4.99,0,10,4.49
"8616",8616,"Space Hodsola",0,3000,3000,3.99,0,87,0.51
"8617",8617,"Way-z",0,3000,3000,0.99,0,30,0.69
"8618",8618,"RectRacer",0,3000,3000,3.99,0,0,3.99
"8619",8619,"Viking Saga: New World",1000,3000,2000,3.99,200,65,1.39
"8620",8620,"How to be Best Russian Game Developer",0,3000,3000,0.99,0,51,0.49
"8621",8621,"Catan VR",1000,3000,2000,14.99,200,34,9.89
"8622",8622,"Fitzzle Precious Dolphins",0,3000,3000,2.99,0,80,0.59
"8623",8623,"Easy Audio Visualization",0,3000,3000,2.99,0,0,2.99
"8624",8624,"Gachi Heroes",0,3000,3000,0.99,0,40,0.59
"8625",8625,"Hexa Turn",1000,3000,2000,2.99,200,75,0.74
"8626",8626,"Alea",1000,3000,2000,7.99,200,90,0.79
"8627",8627,"Protocol",1000,3000,2000,24.99,200,15,21.24
"8628",8628,"Beat Hazard 2",0,3000,3000,18.99,0,20,15.19
"8629",8629,"Chinese Souls-Hua Garden/华夏园",1000,3000,2000,3.99,200,50,1.99
"8630",8630,"Firebird - Steam version",1000,3000,2000,1.99,200,50,0.99
"8631",8631,"Dream Alone",0,3000,3000,9.99,0,67,3.29
"8632",8632,"Mahjong Pretty Manga Girls",0,3000,3000,0.99,0,51,0.49
"8633",8633,"Headliner: NoviNews",0,3000,3000,9.99,0,0,9.99
"8634",8634,"Lucah: Born of a Dream",0,3000,3000,19.99,0,33,13.39
"8635",8635,"Stack & Crack",1000,3000,2000,2.99,200,50,1.49
"8636",8636,"Aggressors: Ancient Rome",0,3000,3000,29.99,0,25,22.49
"8637",8637,"Yeah Jam Fury: U, Me, Everybody!",1000,3000,2000,11.99,200,45,6.59
"8638",8638,"REVENGER: Age of Morons",1000,3000,2000,0.99,200,51,0.49
"8639",8639,"BlindMaze",1000,3000,2000,0.99,200,51,0.49
"8640",8640,"Army Men: Toys in Space",1000,3000,2000,5.99,200,50,2.99
"8641",8641,"Cally's Caves 4",1000,3000,2000,9.99,200,70,2.99
"8642",8642,"Void Monsters: Spring City Tales",1000,3000,2000,4.99,200,66,1.69
"8643",8643,"Disparity",1000,3000,2000,0.99,200,51,0.49
"8644",8644,"Hentai IQ Puzzle",0,3000,3000,0.99,0,51,0.49
"8645",8645,"Save The Cookie",0,3000,3000,0.99,0,0,0.99
"8646",8646,"Lithium: Inmate 39",1000,3000,2000,4.99,200,0,4.99
"8647",8647,"Assault Spy / アサルトスパイ",1000,3000,2000,29.99,200,25,14.99
"8648",8648,"Pro Motion NG",1000,3000,2000,39.99,200,50,19.99
"8649",8649,"Monktastic",0,3000,3000,0.99,0,0,0.99
"8650",8650,"Nevrosa: Escape",1000,3000,2000,14.99,200,34,9.89
"8651",8651,"Puzzles for smart: Cats",0,3000,3000,1.99,0,65,0.69
"8652",8652,"Stefanos Sizzling Pizza Pie",0,3000,3000,0.99,0,51,0.49
"8653",8653,"TRIP",0,3000,3000,1.99,0,0,1.99
"8654",8654,"Two Worlds II HD - Call of the Tenebrae",1000,3000,2000,14.99,200,70,4.49
"8655",8655,"侠隐行录：困境疑云Wuxia archive: Crisis escape",0,3000,3000,8.99,0,10,8.09
"8656",8656,"Wish Project",1000,3000,2000,1.99,200,50,0.99
"8657",8657,"DinoBlaster",1000,3000,2000,4.99,200,0,4.99
"8658",8658,"Swords and Soldiers 2 Shawarmageddon",0,3000,3000,14.99,0,10,13.49
"8659",8659,"BLACK CLOVER: QUARTET KNIGHTS",0,3000,3000,49.99,0,50,24.99
"8660",8660,"Imperialism: Fate of India",0,3000,3000,7.99,0,50,3.99
"8661",8661,"Rewind",1000,3000,2000,8.99,200,50,4.49
"8662",8662,"Road Rage",1000,3000,2000,29.99,200,90,2.99
"8663",8663,"INFERNIUM",1000,3000,2000,24.99,200,80,4.99
"8664",8664,"My Memory of Us",0,3000,3000,17.99,0,30,12.59
"8665",8665,"Cardiganical",0,3000,3000,1.99,0,75,0.49
"8666",8666,"In The Dark",0,3000,3000,4.99,0,50,2.49
"8667",8667,"Formula E: Grand Prix",1000,3000,2000,1.99,200,0,1.99
"8668",8668,"WWTF",0,3000,3000,1.99,0,0,1.99
"8669",8669,"Survival Diary",0,3000,3000,5.99,0,0,5.99
"8670",8670,"Coffee Crawl",1000,3000,2000,4.99,200,80,0.99
"8671",8671,"Grabity",1000,3000,2000,14.99,200,50,7.49
"8672",8672,"Big Surprise",1000,3000,2000,1.99,200,75,0.49
"8673",8673,"Monster shooter",0,3000,3000,0.99,0,40,0.59
"8674",8674,"Neptunian Donut",1000,3000,2000,0.99,200,37,0.62
"8675",8675,"Puzzles By Axis Hyper",0,3000,3000,1.99,0,15,1.69
"8676",8676,"樱花片落恋模样 This is a very sweet love story.",0,3000,3000,29.99,0,0,29.99
"8677",8677,"Hentai Words",0,3000,3000,0.99,0,51,0.49
"8678",8678,"Gone Astray",1000,3000,2000,3.99,200,50,0.99
"8679",8679,"VR Golf Online",1000,3000,2000,19.99,200,0,19.99
"8680",8680,"Hard Work",0,3000,3000,4.99,0,20,3.99
"8681",8681,"Late at night",0,3000,3000,0.99,0,51,0.49
"8682",8682,"LO-OP",0,3000,3000,0.99,0,40,0.59
"8683",8683,"Corral",1000,3000,2000,9.99,200,55,4.49
"8684",8684,"Rhythm World - Master Project",1000,3000,2000,4.99,200,80,0.99
"8685",8685,"Mouse Enhancer Pro",0,3000,3000,3.99,0,20,3.19
"8686",8686,"Eternal Fantasy",0,3000,3000,9.99,0,50,4.99
"8687",8687,"Wayward Souls",0,3000,3000,11.99,0,10,10.79
"8688",8688,"Krim: The Music Bot",0,3000,3000,3.99,0,87,0.51
"8689",8689,"NightmareBullet",0,3000,3000,0.99,0,0,0.99
"8690",8690,"Dungeon Adventure",0,3000,3000,4.99,0,66,1.69
"8691",8691,"Police car chase",0,3000,3000,1.99,0,15,1.69
"8692",8692,"Peninsular War Battles",1000,3000,2000,9.99,200,50,4.99
"8693",8693,"FastGo Running",0,3000,3000,1.99,0,60,0.79
"8694",8694,"Destination Dungeons: Catacombs of Dreams",0,3000,3000,1.99,0,75,0.49
"8695",8695,"RUSH",0,3000,3000,19.99,0,33,13.39
"8696",8696,"Nadia Was Here",1000,3000,2000,11.99,200,50,5.99
"8697",8697,"The Grand Museum VR",0,3000,3000,9.99,0,40,5.99
"8698",8698,"Greedy Guns",1000,3000,2000,14.99,200,55,6.74
"8699",8699,"Gotcha Racing 2nd",0,3000,3000,9.99,0,20,7.99
"8700",8700,"Judge Dredd 95",1000,3000,2000,5.99,200,50,2.99
"8701",8701,"Elminage ORIGINAL - Priestess of Darkness and The Ring of the Gods",1000,3000,2000,9.99,200,30,6.99
"8702",8702,"Hidden Dragon: Legend",1000,3000,2000,14.99,200,70,4.49
"8703",8703,"Cradle of Persia",1000,3000,2000,9.99,200,0,9.99
"8704",8704,"Hexlide",1000,3000,2000,4.99,200,35,3.24
"8705",8705,"Gulman 5",1000,3000,2000,5.99,200,53,2.81
"8706",8706,"Naturallandscape - Three Gorges (自然景观系列-长江三峡)",1000,3000,2000,4.99,200,20,4.49
"8707",8707,"MONOWARS: Red Zone",0,3000,3000,7.99,0,75,1.99
"8708",8708,"Sudoku Original",0,3000,3000,1.99,0,75,0.49
"8709",8709,"Space Transfer",0,3000,3000,17.99,0,0,17.99
"8710",8710,"70 Seconds Survival",0,3000,3000,1.99,0,75,0.49
"8711",8711,"Genghis Khan II: Clan of the Gray Wolf / 蒼き狼と白き牝鹿・元朝秘史",1000,3000,2000,12.99,200,30,9.09
"8712",8712,"NUMERIC",0,3000,3000,1.99,0,30,1.39
"8713",8713,"Trivia King",0,3000,3000,0.99,0,40,0.59
"8714",8714,"Alchemy Classic",0,3000,3000,4.99,0,40,2.99
"8715",8715,"Zork: Grand Inquisitor",1000,3000,2000,5.99,200,35,3.89
"8716",8716,"Mission Of Hero",1000,3000,2000,2.99,200,83,0.5
"8717",8717,"Meme couple",0,3000,3000,0.99,0,51,0.49
"8718",8718,"Sudoku",1000,3000,2000,1.99,200,75,0.49
"8719",8719,"Factory of Monsters",0,3000,3000,1.99,0,60,0.79
"8720",8720,"Lab.Gen.",0,3000,3000,1.99,0,75,0.49
"8721",8721,"Pingball Ultra",0,3000,3000,0.99,0,20,0.79
"8722",8722,"Aim Theory - Trainer",0,3000,3000,3.99,0,0,3.99
"8723",8723,"RGBCELLS",0,3000,3000,0.99,0,51,0.49
"8724",8724,"Road Patrol Truck",0,3000,3000,4.99,0,50,2.49
"8725",8725,"Beyond the Mind",0,3000,3000,0.99,0,40,0.59
"8726",8726,"Make Route",0,3000,3000,0.99,0,51,0.49
"8727",8727,"Cheerleader: reverse side of life",1000,3000,2000,1.99,200,60,0.79
"8728",8728,"Basingstoke",1000,3000,2000,29.99,200,38,18.59
"8729",8729,"Funny Yo",0,3000,3000,1.99,0,75,0.49
"8730",8730,"Tactics & Strategy Master:Joan of Arc",1000,3000,2000,4.99,200,50,2.49
"8731",8731,"Jambo",1000,3000,2000,0.99,200,51,0.49
"8732",8732,"Seduction 誘惑",1000,3000,2000,19.99,200,50,9.99
"8733",8733,"V-Rally 4",0,3000,3000,49.99,0,33,33.49
"8734",8734,"BOX IT",1000,3000,2000,4.99,200,60,1.99
"8735",8735,"Basketball Hoop",0,3000,3000,0.99,0,41,0.58
"8736",8736,"Fitzzle Wise Owls",0,3000,3000,2.99,0,80,0.59
"8737",8737,"Ballz: Farm",1000,3000,2000,0.99,200,51,0.49
"8738",8738,"Bloody and cruel story of toys",1000,3000,2000,4.99,200,60,1.99
"8739",8739,"Distortions",1000,3000,2000,19.99,200,65,6.99
"8740",8740,"BrainyJoy",1000,3000,2000,9.99,200,0,9.99
"8741",8741,"Ranger in Spider's den",0,3000,3000,0.99,0,51,0.49
"8742",8742,"Rescue Quest Gold",1000,3000,2000,9.99,200,75,2.49
"8743",8743,"Doctor Who Infinity",0,3000,3000,11.99,0,0,11.99
"8744",8744,"江湖求生 Ganghood Survival",0,3000,3000,19.99,0,15,16.99
"8745",8745,"Next 2",1000,3000,2000,0.99,200,51,0.49
"8746",8746,"The Internship",1000,3000,2000,0.99,200,51,0.49
"8747",8747,"Ticktock",0,3000,3000,4.99,0,50,2.49
"8748",8748,"Asylamba: Influence",1000,3000,2000,5.99,200,30,4.19
"8749",8749,"Ancient Rush 2",1000,3000,2000,2.99,200,75,0.74
"8750",8750,"Trucker 2",1000,3000,2000,2.99,200,70,0.89
"8751",8751,"Step sisters: Episode 1",0,3000,3000,1.99,0,30,1.39
"8752",8752,"DEATH TRAIN - Warning: Unsafe VR Experience",1000,3000,2000,9.99,200,0,9.99
"8753",8753,"Underwater hunting",0,3000,3000,0.99,0,51,0.49
"8754",8754,"Odd Island",0,3000,3000,4.99,0,0,4.99
"8755",8755,"DareSora: Tears for an Unknown Sky",0,3000,3000,2.99,0,15,2.54
"8756",8756,"SUPER KINKY",0,3000,3000,4.99,0,40,2.99
"8757",8757,"Zeroptian Invasion",0,3000,3000,5.99,0,0,5.99
"8758",8758,"Jolly Battle",0,3000,3000,1.99,0,40,1.59
"8759",8759,"Dyadic",1000,3000,2000,9.99,200,75,2.49
"8760",8760,"Hentai PuZZles",1000,3000,2000,0.99,200,51,0.49
"8761",8761,"Temple of Spikes",1000,3000,2000,9.99,200,0,9.99
"8762",8762,"Ironclads 2: Boshin War",1000,3000,2000,9.99,200,90,0.99
"8763",8763,"Vega Tank",1000,3000,2000,4.99,200,0,4.99
"8764",8764,"Heroes of elements",0,3000,3000,0.99,0,51,0.49
"8765",8765,"Void Memory",1000,3000,2000,9.99,200,50,4.99
"8766",8766,"Be the King",0,3000,3000,1.99,0,40,1.19
"8767",8767,"Galactic Incoming",0,3000,3000,0.99,0,0,0.99
"8768",8768,"Tanita: A Plasticine Dream",1000,3000,2000,4.99,200,80,0.99
"8769",8769,"SkyKeepers",1000,3000,2000,14.99,200,0,14.99
"8770",8770,"Oik 4",0,3000,3000,0.99,0,30,0.69
"8771",8771,"MagiCat",1000,3000,2000,4.99,200,50,3.99
"8772",8772,"Achtung! Cthulhu Tactics",0,3000,3000,24.99,0,25,18.74
"8773",8773,"Battle High 2 A+",1000,3000,2000,4.99,200,80,0.99
"8774",8774,"Enemist",0,3000,3000,0.99,0,40,0.59
"8775",8775,"VR Disc Golf",1000,3000,2000,9.99,200,0,9.99
"8776",8776,"Oppai Puzzle",0,3000,3000,0.99,0,30,0.69
"8777",8777,"GraveRun",1000,3000,2000,7.99,200,50,3.99
"8778",8778,"Hentai Legends",0,3000,3000,1.99,0,50,0.99
"8779",8779,"KO Mech",0,3000,3000,4.99,0,15,4.24
"8780",8780,"Shaq Fu: A Legend Reborn",1000,3000,2000,19.99,200,75,4.99
"8781",8781,"Loops of Zen",1000,3000,2000,2.99,200,0,2.99
"8782",8782,"Cold Vengeance",1000,3000,2000,9.99,200,75,2.49
"8783",8783,"Ignis Avis Venatio",0,3000,3000,19.99,0,10,17.99
"8784",8784,"A Penny For Some Motivation",0,3000,3000,0.99,0,0,0.99
"8785",8785,"Professor Watts Memory Match: Yummy Cupcakes",0,3000,3000,0.99,0,51,0.49
"8786",8786,"Zen Space Flight - VR Showcase",0,3000,3000,1.99,0,30,1.98
"8787",8787,"CANARI",1000,3000,2000,4.99,200,0,4.99
"8788",8788,"The story of Gods 七神物语",0,3000,3000,0.99,0,51,0.49
"8789",8789,"Empire",0,3000,3000,4.99,0,40,2.99
"8790",8790,"The Movie Trivia Challenge",0,3000,3000,0.99,0,40,0.59
"8791",8791,"Pixel shooter",0,3000,3000,0.99,0,40,0.59
"8792",8792,"Able Black",1000,3000,2000,4.99,200,0,4.99
"8793",8793,"Broken Ties",1000,3000,2000,4.99,200,75,1.24
"8794",8794,"Achievement Lurker: We Give Up!",1000,3000,2000,1.99,200,60,0.79
"8795",8795,"Stabby Machine",1000,3000,2000,1.99,200,60,0.79
"8796",8796,"Tactical Mind",1000,3000,2000,2.99,200,50,1.49
"8797",8797,"Dark Rose Valkyrie / クロバラノワルキューレ / 黑玫瑰女武神",1000,3000,2000,29.99,200,85,4.49
"8798",8798,"Professor Watts Memory Match: Expressions",0,3000,3000,0.99,0,51,0.49
"8799",8799,"The Flying Turtle Jewel Quest",1000,3000,2000,3.99,200,75,0.99
"8800",8800,"Slamoids!",0,3000,3000,0.99,0,15,0.84
"8801",8801,"A Tale of Pirates: a Dummy Mutiny",0,3000,3000,3.99,0,80,0.79
"8802",8802,"Sakura MMO",0,3000,3000,9.99,0,25,7.49
"8803",8803,"Longboard Stunts and Tricks",1000,3000,2000,3.99,200,75,1.24
"8804",8804,"Jump Gunners",1000,3000,2000,12.99,200,75,3.24
"8805",8805,"神社的百合香 ~ Floral Aroma in the Shrine",0,3000,3000,0.99,0,51,0.49
"8806",8806,"PROJECT VELOCITY",1000,3000,2000,1.99,200,83,0.5
"8807",8807,"Preventive Strike",1000,3000,2000,1.99,200,30,1.39
"8808",8808,"Orc Slayer",1000,3000,2000,4.99,200,90,0.49
"8809",8809,"Police Quest: SWAT 2",1000,3000,2000,5.99,200,25,4.49
"8810",8810,"Solo",1000,3000,2000,14.99,200,34,9.89
"8811",8811,"TAL: Jungle",0,3000,3000,0.99,0,40,0.59
"8812",8812,"Cycle (轮回)",1000,3000,2000,0.99,200,0,0.99
"8813",8813,"While I Sleep I am Debug",1000,3000,2000,6.99,200,0,6.99
"8814",8814,"Rabbit: Jigsaw Puzzles",1000,3000,2000,0.99,200,51,0.49
"8815",8815,"Bird Memory",0,3000,3000,0.99,0,40,0.59
"8816",8816,"Final Bravely",1000,3000,2000,4.99,200,50,1.99
"8817",8817,"Aim Master",0,3000,3000,2.99,0,0,2.99
"8818",8818,"RECOG The First Wave",0,3000,3000,24.99,0,10,22.49
"8819",8819,"Pleasure Puzzle:Portrait",0,3000,3000,0.99,0,30,0.69
"8820",8820,"Battle Crust",1000,3000,2000,7.99,200,0,7.99
"8821",8821,"Achievement Hunter: Unicorn",1000,3000,2000,0.99,200,51,0.49
"8822",8822,"Ark Noir",0,3000,3000,9.99,0,30,6.99
"8823",8823,"Angry Troll Simulator 2018",0,3000,3000,0.99,0,15,0.84
"8824",8824,"3D Earth Time Lapse PC Live Wallpaper",0,3000,3000,1.99,0,20,1.59
"8825",8825,"Krystal the Adventurer",1000,3000,2000,4.99,200,0,4.99
"8826",8826,"Maidens of a Hollow Dream / 虚夢の乙女",1000,3000,2000,9.99,200,50,4.99
"8827",8827,"Robots 2 Unknown World",0,3000,3000,3.99,0,87,0.51
"8828",8828,"TANKS",1000,3000,2000,4.99,200,50,2.49
"8829",8829,"Siege - Battle of Ashington",0,3000,3000,2.99,0,50,1.49
"8830",8830,"Desire",1000,3000,2000,4.99,200,70,1.49
"8831",8831,"lilGunBois",1000,3000,2000,1.99,200,50,1.99
"8832",8832,"Pixel Killers - The Showdown",0,3000,3000,3.99,0,75,0.99
"8833",8833,"Here Nya",0,3000,3000,0.99,0,40,0.59
"8834",8834,"Fitzzle Fearless Sharks",0,3000,3000,2.99,0,80,0.59
"8835",8835,"Kama Bullet Heritage 2",1000,3000,2000,6.99,200,90,0.69
"8836",8836,"Interstellar Invaders",1000,3000,2000,9.99,200,75,2.49
"8837",8837,"Jets'n'Guns 2",0,3000,3000,11.99,0,0,11.99
"8838",8838,"Tinja",1000,3000,2000,0.99,200,51,0.49
"8839",8839,"Rena And Elin",0,3000,3000,2.99,0,20,2.39
"8840",8840,"Hero Go",1000,3000,2000,1.99,200,50,0.99
"8841",8841,"Lifespan 5seconds",0,3000,3000,1.99,0,0,1.99
"8842",8842,"Impulsion",0,3000,3000,12.99,0,33,8.7
"8843",8843,"Omega Commando",1000,3000,2000,4.99,200,20,3.99
"8844",8844,"Vector Born",0,3000,3000,0.99,0,51,0.49
"8845",8845,"Midnight at the Red Light : An Investigation",1000,3000,2000,3.99,200,70,1.19
"8846",8846,"Cab Driver Commander",0,3000,3000,0.99,0,51,0.49
"8847",8847,"Up And Up",0,3000,3000,0.99,0,51,0.49
"8848",8848,"The Legend of Slime",1000,3000,2000,2.99,200,0,2.99
"8849",8849,"Blade Strangers",0,3000,3000,39.99,0,25,29.99
"8850",8850,"梦本无忧",0,3000,3000,2.99,0,10,2.69
"8851",8851,"不落城-Unconquered Castle",0,3000,3000,4.99,0,30,3.49
"8852",8852,"UAYEB: The Dry Land - Episode 1",1000,3000,2000,19.99,200,60,7.99
"8853",8853,"Fruit couple",0,3000,3000,0.99,0,51,0.49
"8854",8854,"Suicide Guy: Sleepin' Deeply",1000,3000,2000,3.99,200,35,2.59
"8855",8855,"Toilet Run",0,3000,3000,2.99,0,0,2.99
"8856",8856,"Sea Creatures",0,3000,3000,0.99,0,40,0.59
"8857",8857,"The World of Labyrinths: Labyronia",1000,3000,2000,1.99,200,75,0.49
"8858",8858,"Limit of defense",1000,3000,2000,2.99,200,75,0.74
"8859",8859,"Игра забытых Богов. Проснись / Game of the forgotten Gods. Wake up",0,3000,3000,0.99,0,40,0.59
"8860",8860,"Sky Flight",0,3000,3000,0.99,0,40,0.59
"8861",8861,"HUNTER BRICK BALL",0,3000,3000,1.99,0,60,0.79
"8862",8862,"Pixel Shield",0,3000,3000,0.99,0,15,0.84
"8863",8863,"Burden of Proof",0,3000,3000,14.99,0,20,11.99
"8864",8864,"The Mystery of Happyville",0,3000,3000,4.99,0,90,0.49
"8865",8865,"Neon Defense 1 : Pink Power",0,3000,3000,0.99,0,51,0.49
"8866",8866,"Ghost Platoon",1000,3000,2000,14.99,200,70,4.49
"8867",8867,"Monster Adventurer",0,3000,3000,5.99,0,80,1.19
"8868",8868,"Midnight at the Celestial Palace: Chapter I",1000,3000,2000,4.99,200,90,0.99
"8869",8869,"Bliss Maze(极乐迷宫)",0,3000,3000,5.99,0,40,3.59
"8870",8870,"Pool Panic",0,3000,3000,14.99,0,34,9.89
"8871",8871,"Zombitatos: Ultimate Game Of The Year Edition",1000,3000,2000,1.99,200,50,0.99
"8872",8872,"七夜怪谈 - 都市校园禁锢传说",0,3000,3000,0.99,0,0,0.99
"8873",8873,"The Silver Crusade: Aoorha Axeman",0,3000,3000,1.99,0,40,1.19
"8874",8874,"Button Frenzy",1000,3000,2000,4.99,200,80,0.99
"8875",8875,"SiegeVR",1000,3000,2000,4.99,200,75,2.49
"8876",8876,"Monica e a Guarda dos Coelhos",0,3000,3000,14.99,0,0,14.99
"8877",8877,"Time Warpers",0,3000,3000,19.99,0,0,19.99
"8878",8878,"Fat City",0,3000,3000,9.99,0,10,8.99
"8879",8879,"Species: Artificial Life, Real Evolution",0,3000,3000,19.99,0,10,17.99
"8880",8880,"VR GAME-Brick of War 魔块战争",1000,3000,2000,3,200,60,1.2
"8881",8881,"МЫЛО УРОНИЛ",0,3000,3000,0.99,0,51,0.49
"8882",8882,"Monopolist: Technological Revolution",0,3000,3000,1.99,0,66,1.01
"8883",8883,"Crying is not Enough",0,3000,3000,19.99,0,10,17.99
"8884",8884,"Round Mars",1000,3000,2000,0.99,200,51,0.49
"8885",8885,"Cat Demon Island",0,3000,3000,13.99,0,0,13.99
"8886",8886,"Spycraft: The Great Game",1000,3000,2000,5.99,200,75,1.49
"8887",8887,"The Cells",0,3000,3000,0.99,0,40,0.59
"8888",8888,"Tokaido",1000,3000,2000,9.99,200,50,4.99
"8889",8889,"Supesu",0,3000,3000,1.99,0,75,0.49
"8890",8890,"Shatter Quest",1000,3000,2000,7.99,200,0,7.99
"8891",8891,"The Legend of Monster Mountain",0,3000,3000,6.99,0,15,5.94
"8892",8892,"Paradise",1000,3000,2000,1.99,200,80,0.59
"8893",8893,"Harmony of the bravest",1000,3000,2000,7.99,200,85,1.19
"8894",8894,"Horror Fish Simulator",1000,3000,2000,0.99,200,51,0.49
"8895",8895,"Duck Life: Battle",0,3000,3000,3.99,0,0,3.99
"8896",8896,"tiny & Tall: Gleipnir",0,3000,3000,14.99,0,20,11.99
"8897",8897,"Trippy Jump",1000,3000,2000,1.99,200,60,0.79
"8898",8898,"Click and Manage Tycoon",0,3000,3000,3.99,0,66,1.35
"8899",8899,"Not Without You",0,3000,3000,1.99,0,0,1.99
"8900",8900,"LIBRARY",0,3000,3000,1.99,0,0,1.99
"8901",8901,"Gakuen Club",1000,3000,2000,29.99,200,40,17.99
"8902",8902,"VANILLA - GARDEN OF JUDGEMENT",0,3000,3000,14.99,0,0,14.99
"8903",8903,"Living with Jaguars",0,3000,3000,4.99,0,0,4.99
"8904",8904,"Ben 10",1000,3000,2000,29.99,200,50,14.99
"8905",8905,"Corpse Party: Book of Shadows",0,3000,3000,14.99,0,10,13.49
"8906",8906,"Joumee The Hedgehog",1000,3000,2000,1.99,200,70,0.59
"8907",8907,"Crazy Road",1000,3000,2000,0.99,200,51,0.49
"8908",8908,"Pinewood Island",1000,3000,2000,9.99,200,30,6.99
"8909",8909,"Football Mogul 18",1000,3000,2000,7.99,200,80,5.99
"8910",8910,"Dangerous Skies 80's edition",0,3000,3000,1.99,0,75,0.49
"8911",8911,"Professor Watts Word Search: Space Voyage",0,3000,3000,1.99,0,75,0.49
"8912",8912,"Puzzle Sages",1000,3000,2000,1.99,200,0,1.99
"8913",8913,"Wallpaper Builder",0,3000,3000,3.99,0,30,2.79
"8914",8914,"The Goatman",1000,3000,2000,14.99,200,50,7.49
"8915",8915,"TEXT",0,3000,3000,0.99,0,51,0.49
"8916",8916,"MMA Simulator",0,3000,3000,9.99,0,10,8.99
"8917",8917,"Space Fox Kimi",0,3000,3000,4.99,0,85,0.74
"8918",8918,"Indiana Jones and the Infernal Machine",0,3000,3000,5.99,0,15,5.09
"8919",8919,"Dark Maze 2",0,3000,3000,3.99,0,87,0.51
"8920",8920,"Crawl Space: The Mansion",1000,3000,2000,9.99,200,75,2.49
"8921",8921,"Pumpkin Death Garden",0,3000,3000,1.99,0,30,1.39
"8922",8922,"Chronicles of Mystery - The Legend of the Sacred Treasure",0,3000,3000,4.99,0,55,2.24
"8923",8923,"XNemesis",1000,3000,2000,1.99,200,75,0.49
"8924",8924,"Slabs",0,3000,3000,1.99,0,25,1.49
"8925",8925,"Happy Vampire Girl",0,3000,3000,0.99,0,40,0.59
"8926",8926,"Chronicles of Mystery - Secret of the Lost Kingdom",0,3000,3000,4.99,0,55,2.24
"8927",8927,"Space Ranger vs. Reptiloids",0,3000,3000,1.99,0,75,0.49
"8928",8928,"Placement",1000,3000,2000,1.99,200,75,0.49
"8929",8929,"Animals Memory: Cats",1000,3000,2000,0.99,200,51,0.49
"8930",8930,"Space Pilgrim Academy: Year 3",0,3000,3000,1.99,0,50,0.99
"8931",8931,"Super Slime Arena",1000,3000,2000,14.99,200,20,11.99
"8932",8932,"Challenge of the Five Realms: Spellbound in the World of Nhagardia",1000,3000,2000,6.99,200,75,1.74
"8933",8933,"Deep Space Shooter",0,3000,3000,1.99,0,25,1.49
"8934",8934,"SPECKLE: Chill Puzzle Game",1000,3000,2000,0.99,200,51,0.49
"8935",8935,"Kitten and food: adventure park",0,3000,3000,1.99,0,40,1.19
"8936",8936,"Ochkarik",0,3000,3000,1.99,0,75,0.49
"8937",8937,"InfiniPicross 2.0",0,3000,3000,4.99,0,25,3.74
"8938",8938,"Primal Lands",1000,3000,2000,3.99,200,87,0.51
"8939",8939,"Zombie Buster VR",1000,3000,2000,14.99,200,0,14.99
"8940",8940,"Blast",0,3000,3000,4.99,0,0,4.99
"8941",8941,"Build buildings",0,3000,3000,0.99,0,39,0.6
"8942",8942,"ZeroRanger",0,3000,3000,11.99,0,10,10.79
"8943",8943,"Mountain Racing",0,2000,2000,4.99,0,90,0.49
"8944",8944,"SpacePig",0,2000,2000,4.99,0,0,4.99
"8945",8945,"蔚蓝月下 Sapphire Moon",0,2000,2000,3.99,0,26,2.95
"8946",8946,"Outlaws + A Handful of Missions",0,2000,2000,5.99,0,40,3.59
"8947",8947,"No safety",0,2000,2000,0.99,0,51,0.49
"8948",8948,"Ultimate Desktop Character Engine",0,2000,2000,2.99,0,20,2.39
"8949",8949,"CICADS 3301",0,2000,2000,1.99,0,33,1.33
"8950",8950,"TurbOT Racing",0,2000,2000,0.99,0,51,0.49
"8951",8951,"Infliction",0,2000,2000,19.99,0,15,16.99
"8952",8952,"Alien Revival - Episode 1 - Duty Calls",0,2000,2000,1.99,0,33,1.99
"8953",8953,"ZOOMnBOOM",0,2000,2000,1.99,0,25,1.49
"8954",8954,"Mimic",0,2000,2000,0.99,0,51,0.49
"8955",8955,"Plastic soldiers",0,2000,2000,0.99,0,15,0.84
"8956",8956,"The Brink 尘与土的边缘",0,2000,2000,2.99,0,30,0.84
"8957",8957,"Battle Royale Tycoon",0,2000,2000,9.99,0,10,8.99
"8958",8958,"BlackSimulator",0,2000,2000,1.99,0,0,1.99
"8959",8959,"The Castle Disaster 2",0,2000,2000,0.99,0,45,0.54
"8960",8960,"Parkan: Iron Strategy",0,2000,2000,2.99,0,0,2.99
"8961",8961,"Art of Murder - Deadly Secrets",0,2000,2000,4.99,0,55,2.24
"8962",8962,"Jimmy and the Pulsating Mass",0,2000,2000,14.99,0,0,14.99
"8963",8963,"Doujin Jigsaw Puzzle",0,2000,2000,2.99,0,60,1.19
"8964",8964,"Tiny Battle Simulator",0,2000,2000,4.99,0,10,4.49
"8965",8965,"Doodle Farm",0,2000,2000,8.99,0,15,7.64
"8966",8966,"Rabbit of Destiny",0,2000,2000,1.99,0,50,1.49
"8967",8967,"破东荒 - Chaos Of East",0,2000,2000,5.99,0,50,2.99
"8968",8968,"Pit of Evil",0,2000,2000,9.99,0,10,8.99
"8969",8969,"Top Down Racer",0,2000,2000,5.99,0,25,4.49
"8970",8970,"Kamikaze Cube 2",0,2000,2000,0.99,0,51,0.49
"8971",8971,"Accurate Segmentation 2",0,2000,2000,0.99,0,40,0.59
"8972",8972,"Bad Neighbor",0,2000,2000,3.99,0,87,0.51
"8973",8973,"Campido",0,2000,2000,4.99,0,10,4.49
"8974",8974,"MewnBase",0,2000,2000,5.99,0,15,5.09
"8975",8975,"THE E BALL",0,2000,2000,0.99,0,51,0.49
"8976",8976,"The Eerie Inn VR",0,2000,2000,4.99,0,50,2.49
"8977",8977,"Explosive Pursuit",0,2000,2000,0.99,0,40,0.59
"8978",8978,"Holy Sheet",0,2000,2000,2.99,0,8,2.75
"8979",8979,"Archer's story",0,2000,2000,0.99,0,33,0.66
"8980",8980,"RedSun RTS",0,2000,2000,7.99,0,15,6.79
"8981",8981,"Terror",0,2000,2000,5.99,0,10,5.39
"8982",8982,"Achievement Lurker: Another one bites the dust",0,2000,2000,1.99,0,60,0.79
"8983",8983,"SUFFER",0,2000,2000,9.99,0,10,8.99
"8984",8984,"Incredible Mandy",0,2000,2000,14.99,0,0,14.99
"8985",8985,"Retro Snake Adventures",0,2000,2000,0.99,0,51,0.49
"8986",8986,"Russian roulette",0,2000,2000,0.99,0,0,0.99
"8987",8987,"Dungeons & Vampires",0,2000,2000,2.99,0,10,2.69
"8988",8988,"The Turdler",0,2000,2000,1.99,0,50,0.99
"8989",8989,"Zombie Soldier",0,2000,2000,0.99,0,10,0.89
"8990",8990,"Kai Yuen's Overlapped Universe",0,2000,2000,9.99,0,0,9.99
"8991",8991,"Welcome to Princeland",0,2000,2000,4.99,0,10,4.49
"8992",8992,"Fitzzle Gentle Deer",0,2000,2000,2.99,0,80,0.59
"8993",8993,"Keiko Everlasting",0,2000,2000,4.99,0,80,0.99
"8994",8994,"PhotoVidShow",0,2000,2000,24.99,0,20,19.99
"8995",8995,"Seers Isle",0,2000,2000,12.99,0,10,11.69
"8996",8996,"Exposure",0,2000,2000,2.99,0,20,2.39
"8997",8997,"morphe",0,2000,2000,3.99,0,15,3.39
"8998",8998,"Combo Jumper",0,2000,2000,4.99,0,25,3.74
"8999",8999,"Speedy Girls - Dream Team",0,2000,2000,4.99,0,50,2.49
"9000",9000,"Roads of Rome: New Generation 2",0,2000,2000,4.99,0,0,4.99
"9001",9001,"UNHALLOWED: THE CABIN",0,2000,2000,9.99,0,15,9.99
"9002",9002,"Apocalyptic cars war",0,2000,2000,1.99,0,15,1.69
"9003",9003,"crazy maze ~疯狂迷宫 ~ 狂った迷路 ~ Laberinto loco ~ Labyrinthe fou ~ Verrücktes Labyrinth",0,2000,2000,2.99,0,0,2.99
"9004",9004,"Dark Visit",0,2000,2000,1.99,0,60,0.79
"9005",9005,"For the Revenge",0,2000,2000,3.99,0,50,1.99
"9006",9006,"Everything Will Flow 万物皆逝",0,2000,2000,0.99,0,10,0.89
"9007",9007,"BR Logic Pack",0,2000,2000,0.99,0,30,0.69
"9008",9008,"HEAVEN AND HELL - the last war",0,2000,2000,3.99,0,20,3.19
"9009",9009,"rOt 2",0,2000,2000,0.99,0,51,0.49
"9010",9010,"The Boy Who Typed Wolf",0,2000,2000,7.99,0,25,5.99
"9011",9011,"Brain Crush",0,2000,2000,0.99,0,51,0.49
"9012",9012,"Physical Exorcism: Case 01 / 除靈（物理）案件０１",0,2000,2000,2.99,0,40,1.79
"9013",9013,"Silentium 2D",0,2000,2000,1.2,0,30,0.84
"9014",9014,"Xploquest 2",0,2000,2000,2.99,0,80,0.59
"9015",9015,"Age of Gladiators II: Rome",0,2000,2000,19.99,0,25,14.99
"9016",9016,"11-11 Memories Retold",0,2000,2000,29.99,0,0,29.99
"9017",9017,"Papper Balls",0,2000,2000,0.99,0,51,0.49
"9018",9018,"Pixel Maze",0,2000,2000,3.99,0,20,3.19
"9019",9019,"LoveKami -Healing Harem-",0,2000,2000,12.99,0,10,11.69
"9020",9020,"Aggelos",0,2000,2000,14.99,0,20,11.99
"9021",9021,"Lovestory",0,2000,2000,5.99,0,70,1.79
"9022",9022,"Drop Up",0,2000,2000,1.99,0,0,1.99
"9023",9023,"Jelly Wants More",0,2000,2000,5.99,0,50,2.99
"9024",9024,"Gold Digger Maze",0,2000,2000,2.99,0,84,0.49
"9025",9025,"ArchaeologyX",0,2000,2000,8.99,0,0,8.99
"9026",9026,"Bikini Heaven",0,2000,2000,1.99,0,15,1.69
"9027",9027,"TRAGO",0,2000,2000,4.99,0,0,4.99
"9028",9028,"Legacy of Lina",0,2000,2000,3.99,0,25,2.99
"9029",9029,"Jay Walker",0,2000,2000,3.99,0,80,0.79
"9030",9030,"Franchise Hockey Manager 5",0,2000,2000,39.99,0,25,29.99
"9031",9031,"Fallen Sky Online",0,2000,2000,4.99,0,50,2.49
"9032",9032,"Pixel Puzzles 2: Christmas",0,2000,2000,9.99,0,15,8.49
"9033",9033,"Cabins: Jigsaw Puzzles",0,2000,2000,1.99,0,50,0.99
"9034",9034,"The Land of the Seazogs",0,2000,2000,5.99,0,10,5.39
"9035",9035,"Bernie’s Nightmare",0,2000,2000,1.99,0,15,1.69
"9036",9036,"Wild Animal Sports Day",0,2000,2000,4.99,0,33,3.34
"9037",9037,"Vagrant Fury",0,2000,2000,7.99,0,60,3.19
"9038",9038,"Board Battlefield",0,2000,2000,1.99,0,15,1.69
"9039",9039,"Dead Dungeon",0,2000,2000,4.99,0,15,4.24
"9040",9040,"Land of Puzzles: Battles",0,2000,2000,0.99,0,51,0.49
"9041",9041,"Amulet Zero 零物语 - Optimize",0,2000,2000,0.99,0,40,0.59
"9042",9042,"Loria",0,2000,2000,18.99,0,25,14.24
"9043",9043,"Sleep Tight",0,2000,2000,14.99,0,0,14.99
"9044",9044,"KeepShopkeeping",0,2000,2000,9.99,0,50,4.99
"9045",9045,"CanYouSurvive?",0,2000,2000,0.99,0,0,0.99
"9046",9046,"Adventure Game",0,2000,2000,14.99,0,0,14.99
"9047",9047,"Toltec and the mysteries of the Secret Island",0,2000,2000,10.99,0,0,10.99
"9048",9048,"Ninjin: Clash of Carrots",0,2000,2000,14.99,0,50,7.49
"9049",9049,"Stifled",0,2000,2000,19.99,0,20,15.99
"9050",9050,"Sarah in the Sky",0,2000,2000,2.99,0,66,1.01
"9051",9051,"Catastronauts",0,2000,2000,15.99,0,0,15.99
"9052",9052,"Don't Feed The Slimes!",0,2000,2000,3.99,0,20,3.19
"9053",9053,"Life's Playground",0,2000,2000,1.99,0,60,0.79
"9054",9054,"God Vs Zombies",0,2000,2000,3.99,0,80,0.79
"9055",9055,"The SOL Device",0,2000,2000,4.99,0,80,0.99
"9056",9056,"Tales of the Wedding Rings VR",0,2000,2000,19.99,0,0,19.99
"9057",9057,"Armored Train",0,2000,2000,1.99,0,60,0.79
"9058",9058,"vridniX",0,2000,2000,9.99,0,30,6.99
"9059",9059,"Invaders! From Outer Space",0,2000,2000,4.99,0,0,0.99
"9060",9060,"Talk to Yuno",0,2000,2000,2.99,0,15,2.54
"9061",9061,"TailzFromTheGrave",0,2000,2000,2.99,0,60,1.19
"9062",9062,"Caves of Plague",0,2000,2000,1.99,0,20,1.59
"9063",9063,"Myst IV: Revelation",0,2000,2000,14.99,0,40,8.99
"9064",9064,"Axis Football 2018",0,2000,2000,19.99,0,10,17.99
"9065",9065,"Steel Rats",0,2000,2000,19.99,0,15,16.99
"9066",9066,"The Chambers",0,2000,2000,1.99,0,50,0.99
"9067",9067,"Sanguine Sanctum",0,2000,2000,4.99,0,33,3.34
"9068",9068,"Peter World",0,2000,2000,5.99,0,50,2.99
"9069",9069,"Fly High",0,2000,2000,0.99,0,30,0.69
"9070",9070,"Super Destronaut DX",0,2000,2000,4.99,0,15,4.24
"9071",9071,"Audio Converter",0,2000,2000,6.99,0,50,3.49
"9072",9072,"School Idol",0,2000,2000,1.99,0,30,1.99
"9073",9073,"Driftpunk Racer",0,2000,2000,6.99,0,50,3.49
"9074",9074,"Boo Boo Bananas",0,2000,2000,3.99,0,55,1.79
"9075",9075,"Roving in the Dark",0,2000,2000,9.99,0,75,2.49
"9076",9076,"The Real Laser Ball",0,2000,2000,0.99,0,40,0.59
"9077",9077,"Deported: Drain the Swamp",0,2000,2000,0.99,0,40,0.59
"9078",9078,"PUT ANNA",0,2000,2000,0.99,0,33,0.66
"9079",9079,"Fitzzle Cute Kittens",0,2000,2000,2.99,0,80,0.59
"9080",9080,"Rise:30 Minutes to Extinction",0,2000,2000,4.99,0,20,3.99
"9081",9081,"Captain:Training",0,2000,2000,2.99,0,30,2.09
"9082",9082,"SUPER BALL WRESTLE YES",0,2000,2000,10.99,0,20,8.79
"9083",9083,"Evolo.Mine",0,2000,2000,0.99,0,25,0.74
"9084",9084,"纸片人3D",0,2000,2000,10.99,0,0,10.99
"9085",9085,"Break The Targets",0,2000,2000,4.99,0,25,3.74
"9086",9086,"A.D.M(Angels,Demons And Men)",0,2000,2000,9.99,0,90,0.99
"9087",9087,"One Jump Bomb",0,2000,2000,2.99,0,50,1.49
"9088",9088,"Reentry - An Orbital Simulator",0,2000,2000,19.99,0,15,16.99
"9089",9089,"Mind Trap",0,2000,2000,3.99,0,87,0.51
"9090",9090,"MochiMochi",0,2000,2000,0.99,0,0,0.99
"9091",9091,"Adventures in the Light & Dark",0,2000,2000,3.99,0,60,1.59
"9092",9092,"MeatPossible: Chapter 1.5",0,2000,2000,3.99,0,50,1.99
"9093",9093,"TETRA's Escape",0,2000,2000,4.99,0,20,3.99
"9094",9094,"Bedlamball",0,2000,2000,5.99,0,30,4.19
"9095",9095,"NCradle: An 80s Synth Adventure",0,2000,2000,7.99,0,0,7.99
"9096",9096,"Because We're Here ~Mohnblume und Blauerose~ Act I",0,2000,2000,5.99,0,15,5.09
"9097",9097,"Wildest of the Wild",0,2000,2000,4.99,0,20,3.99
"9098",9098,"Space Raiders RPG",0,2000,2000,4.99,0,0,4.99
"9099",9099,"Professor Watts Memory Match: Puppies",0,2000,2000,0.99,0,51,0.49
"9100",9100,"The Enthralling Realms",0,2000,2000,2.99,0,50,1.49
"9101",9101,"Audio Editor",0,2000,2000,8.99,0,50,4.49
"9102",9102,"_dive",0,2000,2000,1.99,0,50,0.99
"9103",9103,"Dare Course",0,2000,2000,5.99,0,50,2.99
"9104",9104,"Pilot Rudder VR",0,2000,2000,9.99,0,75,2.49
"9105",9105,"Count Logica",0,2000,2000,1.99,0,10,1.79
"9106",9106,"NAIRI: Tower of Shirin",0,2000,2000,9.99,0,0,9.99
"9107",9107,"Flynn and Freckles",0,2000,2000,14.99,0,50,7.49
"9108",9108,"A Lot Like Love",0,2000,2000,4.99,0,90,0.49
"9109",9109,"RAZ",0,2000,2000,4.99,0,75,1.24
"9110",9110,"POWERCUT, Inc.",0,2000,2000,2.99,0,0,2.99
"9111",9111,"Temple of the Lost",0,2000,2000,3.99,0,75,0.99
"9112",9112,"Boons Farm",0,2000,2000,0.99,0,75,0.49
"9113",9113,"Shooting over it : to be a star",0,2000,2000,3.99,0,15,3.39
"9114",9114,"Verlet Swing",0,2000,2000,14.99,0,20,11.99
"9115",9115,"Lilipalace",0,2000,2000,12.99,0,15,11.04
"9116",9116,"Fairyland: The Guild",0,2000,2000,4.99,0,75,1.24
"9117",9117,"Adva-lines",0,2000,2000,4.99,0,20,2.99
"9118",9118,"Typical Nightmare",0,2000,2000,9.99,0,80,1.99
"9119",9119,"Useless Box",0,2000,2000,1.99,0,60,0.79
"9120",9120,"Death Fungeon",0,2000,2000,1.99,0,50,0.99
"9121",9121,"Time Virus",0,2000,2000,0.99,0,20,0.99
"9122",9122,"Skeletal Dance Party",0,2000,2000,8.99,0,13,7.82
"9123",9123,"To Trust an Incubus",0,2000,2000,19.99,0,0,19.99
"9124",9124,"BattleBlade",0,2000,2000,3.99,0,30,2.79
"9125",9125,"Wizards Tourney",0,2000,2000,9.99,0,26,7.39
"9126",9126,"Khospis",0,2000,2000,0.99,0,0,0.99
"9127",9127,"美少女麻将接龙",0,2000,2000,1.99,0,50,0.99
"9128",9128,"GARAGE: Bad Trip",0,2000,2000,14.99,0,50,7.49
"9129",9129,"Color by Numbers - Halloween",0,2000,2000,3.99,0,15,3.39
"9130",9130,"AngeliaLost",0,2000,2000,7.99,0,0,7.99
"9131",9131,"Fortified Swiss",0,2000,2000,14.99,0,20,11.99
"9132",9132,"Firmament Wars",0,2000,2000,4.99,0,0,4.99
"9133",9133,"428: Shibuya Scramble",0,2000,2000,49.99,0,40,29.99
"9134",9134,"Fiber Twig 2",0,2000,2000,9.99,0,66,3.39
"9135",9135,"Woodpunk",0,2000,2000,19.99,0,10,17.99
"9136",9136,"HecatoncheirStory",0,2000,2000,0.99,0,51,0.49
"9137",9137,"Danger Zone 2",0,2000,2000,19.99,0,40,11.99
"9138",9138,"Guilty Summer Kiss 2 - Bloody Secret",0,2000,2000,6.99,0,50,3.49
"9139",9139,"Automatum",0,2000,2000,5.99,0,60,2.39
"9140",9140,"Modern tactics",0,2000,2000,1.99,0,10,0.99
"9141",9141,"Viviette",0,2000,2000,9.99,0,11,8.89
"9142",9142,"SAVANNA SHOT VR",0,2000,2000,13.99,0,50,6.99
"9143",9143,"Chroma : Sexy Hentai Girls",0,2000,2000,0.99,0,51,0.49
"9144",9144,"Arcane Golf",0,2000,2000,8.99,0,50,4.49
"9145",9145,"Kitten Love Emulator",0,2000,2000,4.99,0,20,3.99
"9146",9146,"MiniCar Race",0,2000,2000,2.99,0,80,0.59
"9147",9147,"Party Mixer 3D",0,2000,2000,8.99,0,50,4.49
"9148",9148,"Master of Rogues - The Seven Artifacts",0,2000,2000,4.99,0,40,2.99
"9149",9149,"The way to defeat the Archfiend / 打倒魔王的方法",0,2000,2000,1.99,0,60,0.79
"9150",9150,"Flowers -Le volume sur ete-",0,2000,2000,19.99,0,10,17.99
"9151",9151,"Little Bug",0,2000,2000,9.99,0,10,8.99
"9152",9152,"Battle royale simulator",0,2000,2000,3.99,0,40,3.59
"9153",9153,"King of Queendoms",0,2000,2000,1.99,0,10,1.79
"9154",9154,"Ghostbusters VR: Now Hiring",0,2000,2000,9.99,0,34,6.59
"9155",9155,"FPV Freerider",0,2000,2000,5.99,0,0,5.99
"9156",9156,"Blood Card",0,2000,2000,5.99,0,30,4.19
"9157",9157,"SpaceExile",0,2000,2000,4.99,0,83,0.49
"9158",9158,"LOTUS-Simulator",0,2000,2000,49.99,0,0,49.99
"9159",9159,"Accurate Segmentation 3",0,2000,2000,0.99,0,40,0.59
"9160",9160,"Hinterhalt 2",0,2000,2000,9.99,0,80,1.99
"9161",9161,"Hexanome",0,2000,2000,2.99,0,20,2.39
"9162",9162,"EXCHANGE",0,2000,2000,4.99,0,15,4.24
"9163",9163,"Game of Stones",0,2000,2000,8.99,0,70,2.69
"9164",9164,"YOU - The Untold Stories",0,2000,2000,3.99,0,30,2.79
"9165",9165,"Code51:Mecha Arena",0,2000,2000,19.99,0,60,7.99
"9166",9166,"Nonogram",0,2000,2000,4.99,0,10,4.49
"9167",9167,"Ultimate War",0,2000,2000,5.99,0,10,5.39
"9168",9168,"Lucky Night: Poker Games",0,2000,2000,0.99,0,0,0.99
"9169",9169,"Witch Thief",0,2000,2000,19.99,0,20,15.99
"9170",9170,"A Top-Down Job: Blood Gain",0,2000,2000,1.99,0,35,1.29
"9171",9171,"Wandering Owl",0,2000,2000,3.99,0,10,3.59
"9172",9172,"MODERN ROAD-LIKE",0,2000,2000,0.99,0,10,0.89
"9173",9173,"Kumpels",0,2000,2000,11.99,0,10,10.79
"9174",9174,"Hoyeonjigi",0,2000,2000,3.99,0,10,3.59
"9175",9175,"The Experiment: Escape Room",0,2000,2000,3.99,0,10,3.59
"9176",9176,"Speed Brawl",0,2000,2000,19.99,0,10,17.99
"9177",9177,"Headsnatchers",0,2000,2000,14.99,0,25,11.24
"9178",9178,"Debit And Credit:A Walk Through Accounting Hell",0,2000,2000,2.99,0,30,2.09
"9179",9179,"Monster Farm",0,2000,2000,2.99,0,84,0.49
"9180",9180,"Big Day",0,2000,2000,9.99,0,20,7.99
"9181",9181,"Suzy Cube",0,2000,2000,7.99,0,75,1.99
"9182",9182,"Balloon Strike",0,2000,2000,2.99,0,84,0.49
"9183",9183,"Aeon of Sands - The Trail",0,2000,2000,19.99,0,10,17.99
"9184",9184,"Death Trader: Cold War",0,2000,2000,7.99,0,30,5.59
"9185",9185,"TAL: Arctic 2",0,2000,2000,0.99,0,51,0.49
"9186",9186,"Desert Rescue",0,2000,2000,18.99,0,0,18.99
"9187",9187,"RoomESC- Secret of the Hidden Room: the Collaborator",0,2000,2000,4.99,0,10,4.49
"9188",9188,"Turn the mirror, please.",0,2000,2000,0.99,0,30,0.69
"9189",9189,"Chicken VR",0,2000,2000,2.99,0,30,2.09
"9190",9190,"The Entity",0,2000,2000,4.99,0,40,2.99
"9191",9191,"Little World Of Creatures",0,2000,2000,3.99,0,40,2.39
"9192",9192,"Octo Gravity",0,2000,2000,0.99,0,25,0.74
"9193",9193,"Arcane Trials",0,2000,2000,4.99,0,40,2.99
"9194",9194,"Rugosi",0,2000,2000,0.99,0,0,0.99
"9195",9195,"Dimetrosaur",0,2000,2000,10.99,0,10,9.89
"9196",9196,"Skywriter",0,2000,2000,3.99,0,75,0.99
"9197",9197,"Muddledash",0,2000,2000,5.99,0,40,3.59
"9198",9198,"Arauco Saga - Rpg Action",0,2000,2000,17.99,0,10,16.19
"9199",9199,"Mega Milk Story",0,2000,2000,13.99,0,30,9.79
"9200",9200,"JumpJumpMania",0,2000,2000,0.99,0,40,0.59
"9201",9201,"Crime Girl",0,2000,2000,9.99,0,80,1.99
"9202",9202,"Absinth",0,2000,2000,13,0,25,9.75
"9203",9203,"Mushroom Quest",0,2000,2000,2.99,0,55,0.99
"9204",9204,"Land of Puzzles: Knights",0,2000,2000,0.99,0,51,0.49
"9205",9205,"ColdByte Server Composer",0,2000,2000,19.99,0,20,15.99
"9206",9206,"your diary+",0,2000,2000,24.99,0,30,17.49
"9207",9207,"Pixel Ripped 1989",0,2000,2000,24.99,0,25,18.74
"9208",9208,"Horror Rollercoaster",0,2000,2000,0.99,0,51,0.49
"9209",9209,"Fant Kids Matching Game",0,2000,2000,5.99,0,20,4.79
"9210",9210,"Guards of the Gate",0,2000,2000,9.99,0,15,8.49
"9211",9211,"Rope Racer O'Neon",0,2000,2000,2.99,0,15,2.54
"9212",9212,"Social Club VR : Casino Nights",0,2000,2000,19.99,0,50,9.99
"9213",9213,"Space Hodsola 2",0,2000,2000,0.99,0,51,0.49
"9214",9214,"Sexy Furry Puzzle",0,2000,2000,0.99,0,40,0.59
"9215",9215,"Quixer",0,2000,2000,1.99,0,15,1.69
"9216",9216,"Tee Time Golf",0,2000,2000,9.99,0,30,6.99
"9217",9217,"Love Letter",0,2000,2000,6.99,0,0,6.99
"9218",9218,"Broken Reality",0,2000,2000,14.99,0,10,13.49
"9219",9219,"机能女孩-Energy Girl",0,2000,2000,3.99,0,0,3.99
"9220",9220,"Hotel Sowls",0,2000,2000,3.99,0,0,3.99
"9221",9221,"DarkDIRE",0,2000,2000,4.99,0,15,4.24
"9222",9222,"Hentai 2+2=4",0,2000,2000,0.99,0,51,0.49
"9223",9223,"Dead Shot Heroes",0,2000,2000,9.99,0,0,9.99
"9224",9224,"Wet Warfare",0,2000,2000,1.99,0,0,1.99
"9225",9225,"Edepth Angel: Pinocchio's Murder",0,2000,2000,14.99,0,0,14.99
"9226",9226,"Blood 'n Bikinis",0,2000,2000,9.99,0,30,6.99
"9227",9227,"Granny",0,2000,2000,9.99,0,0,9.99
"9228",9228,"Dr. Schplot's Nanobots",0,2000,2000,6.99,0,0,6.99
"9229",9229,"Fairy Rescue",0,2000,2000,2.99,0,84,0.49
"9230",9230,"Fairy Tower Defense",0,2000,2000,4.99,0,90,0.49
"9231",9231,"Hyperborean Charter",0,2000,2000,4.99,0,0,4.99
"9232",9232,"Best Of Fight",0,2000,2000,0.99,0,40,0.59
"9233",9233,"Catgirl Magic: Furry Duel",0,2000,2000,3.99,0,75,0.99
"9234",9234,"M-Plan",0,2000,2000,3.99,0,49,2.03
"9235",9235,"V nekotorom tsarstve",0,2000,2000,0.99,0,51,0.49
"9236",9236,"White Nothing",0,2000,2000,1.99,0,75,0.49
"9237",9237,"PASSAGE",0,2000,2000,5.99,0,0,5.99
"9238",9238,"Lost in Harmony",0,2000,2000,6.99,0,40,4.19
"9239",9239,"The Tower of Beatrice",0,2000,2000,5.99,0,20,4.79
"9240",9240,"Divine Miracle Defense",0,2000,2000,2.99,0,51,1.46
"9241",9241,"Ray of Light",0,2000,2000,0.99,0,70,0.89
"9242",9242,"Super Nosebleed Land",0,2000,2000,2.99,0,50,1.49
"9243",9243,"Abha ""Light on the Path""",0,2000,2000,3.99,0,0,3.99
"9244",9244,"Red Beard Labyrinth",0,2000,2000,3.99,0,10,3.59
"9245",9245,"Tank Bung",0,2000,2000,0.99,0,51,0.49
"9246",9246,"Universally Loved",0,2000,2000,1.99,0,20,1.59
"9247",9247,"Mazetools Soniface (Lab Edition)",0,2000,2000,29.99,0,25,22.49
"9248",9248,"Reignfall",0,2000,2000,9.99,0,25,7.49
"9249",9249,"Small Sister",0,2000,2000,4.99,0,80,0.99
"9250",9250,"Maso Marble",0,2000,2000,3.99,0,0,3.99
"9251",9251,"Descending",0,2000,2000,11.99,0,0,11.99
"9252",9252,"The Legacy: Prisoner",0,2000,2000,6.99,0,0,6.99
"9253",9253,"Strip Breaker : Hentai Girls",0,2000,2000,0.99,0,51,0.49
"9254",9254,"Ascending Madness",0,2000,2000,9.99,0,20,7.99
"9255",9255,"Granny's Grantastic Granventure",0,2000,2000,9.99,0,50,4.99
"9256",9256,"Atlas Tile Editor (ATE)",0,2000,2000,4.99,0,25,3.74
"9257",9257,"Witch's Tales",0,2000,2000,5.99,0,40,3.59
"9258",9258,"Digital Siege",0,2000,2000,6.99,0,50,3.49
"9259",9259,"Super BOO Quest",0,2000,2000,1.99,0,25,1.49
"9260",9260,"You have a drunk friend",0,2000,2000,4.99,0,26,3.69
"9261",9261,"Chronus Arc",0,2000,2000,12.99,0,10,11.69
"9262",9262,"Anima: Gate of Memories - The Nameless Chronicles",0,2000,2000,19.99,0,25,14.99
"9263",9263,"FINSummerVR",0,2000,2000,5.99,0,75,1.49
"9264",9264,"Time Splatter",0,2000,2000,0.99,0,40,0.59
"9265",9265,"Hop Step Sing! Nozokanaide Naked Heart (HQ Edition)",0,2000,2000,6.99,0,25,5.24
"9266",9266,"Dear Apothecary",0,2000,2000,3.99,0,15,3.39
"9267",9267,"Tilesweeper",0,2000,2000,4.99,0,0,4.99
"9268",9268,"Hentai: The Shell Game",0,2000,2000,0.99,0,40,0.59
"9269",9269,"Space Toads Mayhem",0,2000,2000,3.99,0,15,3.39
"9270",9270,"PixZomb",0,2000,2000,0.99,0,51,0.49
"9271",9271,"Catfender",0,2000,2000,2.99,0,15,2.54
"9272",9272,"RogueLite",0,2000,2000,1.99,0,40,1.19
"9273",9273,"CoreOptimizer",0,2000,2000,9.99,0,30,1.99
"9274",9274,"Zenesthetic",0,2000,2000,6.99,0,50,3.49
"9275",9275,"Neverliria",0,2000,2000,5.99,0,25,4.49
"9276",9276,"Grisaia Phantom Trigger Vol.5",0,2000,2000,14.99,0,10,13.49
"9277",9277,"Supaplex SQUARES",0,2000,2000,9.99,0,70,2.99
"9278",9278,"Fairyland: Power Dice",0,2000,2000,2.99,0,83,0.5
"9279",9279,"Windlands 2",0,2000,2000,29.99,0,10,26.99
"9280",9280,"MUSEUM VOLUME I",0,2000,2000,0.99,0,0,0.99
"9281",9281,"Choice of Broadsides: HMS Foraker",0,2000,2000,4.99,0,40,2.99
"9282",9282,"I Hate Heroes: Rocket Man",0,2000,2000,5.99,0,33,4.01
"9283",9283,"HerWam",0,2000,2000,2.99,0,35,1.94
"9284",9284,"Crystal Vibes feat. Ott.",0,2000,2000,0.99,0,10,0.99
"9285",9285,"The Slater",0,2000,2000,14.99,0,40,8.99
"9286",9286,"Paw Patrol: On A Roll!",0,2000,2000,29.99,0,0,29.99
"9287",9287,"Overdungeon",0,2000,2000,14.99,0,0,14.99
"9288",9288,"Masked Forces 3",0,2000,2000,4.99,0,80,0.99
"9289",9289,"Beach Pong",0,2000,2000,1.99,0,75,0.49
"9290",9290,"SFD",0,2000,2000,7.99,0,30,5.59
"9291",9291,"Barbearian",0,2000,2000,14.99,0,10,13.49
"9292",9292,"GrabBag",0,2000,2000,1.99,0,60,0.79
"9293",9293,"Became The Hunted",0,2000,2000,5.99,0,0,5.99
"9294",9294,"The Spirit Master of Retarnia -Conqueror of the Labyrinth-",0,2000,2000,14.99,0,25,11.24
"9295",9295,"RoboBall",0,2000,2000,4.99,0,40,2.99
"9296",9296,"The Chronicles of Quiver Dick",0,2000,2000,2.99,0,50,0.99
"9297",9297,"TANK SOULS",0,2000,2000,1.99,0,50,0.99
"9298",9298,"Jar Sam",0,2000,2000,0.99,0,10,0.99
"9299",9299,"Substance Designer 2019",0,2000,2000,149.99,0,34,98.99
"9300",9300,"Intelligence: Dinosaurs",0,2000,2000,1.99,0,70,0.59
"9301",9301,"Viki Spotter: Professions",0,2000,2000,0.99,0,51,0.49
"9302",9302,"Poltergeist Treasure",0,2000,2000,4.99,0,0,4.99
"9303",9303,"Egress",0,2000,2000,14.99,0,15,12.74
"9304",9304,"Snares of Ruin Zero",0,2000,2000,2.99,0,20,2.39
"9305",9305,"Lightfield HYPER Edition",0,2000,2000,14.99,0,33,10.04
"9306",9306,"Thievery",0,2000,2000,2.99,0,40,1.79
"9307",9307,"Epic Loon",0,2000,2000,9.99,0,50,7.49
"9308",9308,"Cine Tracer",0,2000,2000,89.99,0,0,89.99
"9309",9309,"Parkour Polygon",0,2000,2000,2.99,0,0,2.99
"9310",9310,"Slay The Dragon",0,2000,2000,2.99,0,0,2.99
"9311",9311,"INSPACE 2980",0,2000,2000,5.99,0,70,1.79
"9312",9312,"Project Warlock",0,2000,2000,12,0,0,12
"9313",9313,"Keyhole Spy: Student Girls",0,2000,2000,4.99,0,50,2.49
"9314",9314,"CastleGuard",0,2000,2000,5.99,0,33,2
"9315",9315,"ELF",0,2000,2000,4.99,0,50,2.49
"9316",9316,"Deported 2: Build That Wall",0,2000,2000,0.99,0,40,0.59
"9317",9317,"Les Misérables: Cosette's Fate",0,2000,2000,2.99,0,20,2.39
"9318",9318,"SOMOS",0,2000,2000,7.99,0,15,6.79
"9319",9319,"Laggerjack",0,2000,2000,1.99,0,40,1.19
"9320",9320,"Cosmic Ray",0,2000,2000,2.99,0,25,2.24
"9321",9321,"unBorn",0,2000,2000,1.99,0,0,1.99
"9322",9322,"Sally's Salon: Kiss & Make-Up",0,2000,2000,12.99,0,50,6.49
"9323",9323,"Hentai Memory Puzzles",0,2000,2000,0.99,0,20,0.79
"9324",9324,"Antiquitas",0,2000,2000,2.99,0,0,2.99
"9325",9325,"The Fiend's Tavern",0,2000,2000,4.99,0,50,2.49
"9326",9326,"TAL: Arctic 3",0,2000,2000,0.99,0,51,0.49
"9327",9327,"IMAZE.EXE",0,2000,2000,0.99,0,51,0.49
"9328",9328,"MoonQuest",0,2000,2000,11.99,0,0,11.99
"9329",9329,"Super Street: The Game",0,2000,2000,39.99,0,30,34.99
"9330",9330,"Vein Hotel",0,2000,2000,3.99,0,20,3.19
"9331",9331,"Double Stretch",0,2000,2000,0.99,0,51,0.49
"9332",9332,"Don't Play With Dolls",0,2000,2000,2.99,0,25,2.24
"9333",9333,"Spellrune: Realm of Portals",0,2000,2000,9.99,0,30,6.99
"9334",9334,"Before Nightfall",0,2000,2000,0.99,0,40,0.59
"9335",9335,"Propaganda Llama",0,2000,2000,7.99,0,10,7.19
"9336",9336,"Jubox 2",0,2000,2000,0.99,0,51,0.49
"9337",9337,"Yuzi Lims: Hentai",0,2000,2000,0.99,0,40,0.59
"9338",9338,"Legend of Assassin: Egypt",0,2000,2000,1.99,0,75,0.49
"9339",9339,"DMD Branefold",0,2000,2000,1.99,0,25,1.99
"9340",9340,"Another Hardcore Game",0,2000,2000,1.99,0,20,1.59
"9341",9341,"Escape from the Princess",0,2000,2000,7.99,0,40,4.79
"9342",9342,"Best Life Simulator",0,2000,2000,1.99,0,10,1.79
"9343",9343,"Synced Warriors",0,2000,2000,1.99,0,50,0.99
"9344",9344,"Technolites: Episode 1",0,2000,2000,7.99,0,0,7.99
"9345",9345,"Youropa",0,2000,2000,24.99,0,52,11.99
"9346",9346,"COLINA: Legacy",0,2000,2000,9.99,0,25,7.49
"9347",9347,"探灵警探",0,2000,2000,0.99,0,51,0.49
"9348",9348,"The Z Axis: Continuum",0,2000,2000,9.99,0,25,7.49
"9349",9349,"Jewel Match Solitaire",0,2000,2000,9.99,0,30,6.99
"9350",9350,"Lovecraft's Untold Stories",0,2000,2000,12.99,0,0,12.99
"9351",9351,"Croquet Pro 2",0,2000,2000,6.99,0,12,6.15
"9352",9352,"GUNS 'n GUTS",0,2000,2000,0.99,0,0,0.99
"9353",9353,"Lems",0,2000,2000,17.99,0,10,16.19
"9354",9354,"RoboVDino",0,2000,2000,4.99,0,20,3.99
"9355",9355,"Eraser & Builder",0,2000,2000,1.99,0,40,1.19
"9356",9356,"Save Them",0,2000,2000,2.99,0,50,1.49
"9357",9357,"Shadow Council: The Puppeteers",0,2000,2000,6.99,0,50,3.49
"9358",9358,"Black Moon 黑月",0,2000,2000,0.99,0,34,0.65
"9359",9359,"Fajoce",0,2000,2000,4.99,0,90,0.49
"9360",9360,"Rage in Peace",0,2000,2000,12.99,0,10,11.69
"9361",9361,"PackageRun",0,2000,2000,4.99,0,60,1.99
"9362",9362,"The King's Bird",0,2000,2000,19.99,0,50,9.99
"9363",9363,"New Dawn",0,2000,2000,18.99,0,32,12.91
"9364",9364,"JUMP AND RUN - DON'T FALL",0,2000,2000,2.99,0,40,2.99
"9365",9365,"Chiptune DJ",0,2000,2000,2.99,0,75,0.74
"9366",9366,"The Earth Dies Screaming",0,2000,2000,0.99,0,0,0.99
"9367",9367,"Pit Blocks 3D",0,2000,2000,19.99,0,65,6.99
"9368",9368,"Jade's Dungeon Descent",0,2000,2000,1.99,0,25,1.49
"9369",9369,"One Gun: Cat",0,2000,2000,1.99,0,40,1.19
"9370",9370,"Scary defense",0,2000,2000,1.99,0,51,0.49
"9371",9371,"Waking Violet",0,2000,2000,6.99,0,50,3.49
"9372",9372,"Operation Thunderstorm",0,2000,2000,4.99,0,40,2.99
"9373",9373,"Future City Coaster",0,2000,2000,1.99,0,75,0.49
"9374",9374,"Sheepageddon",0,2000,2000,0.99,0,40,0.59
"9375",9375,"Achievement Lurker: Ballad of the Shimapan Warrior - King of Panties",0,2000,2000,1.99,0,50,0.99
"9376",9376,"Ball Platformer",0,2000,2000,1.99,0,0,1.99
"9377",9377,"Country Park",0,2000,2000,0.99,0,45,0.54
"9378",9378,"Export Simulator",0,2000,2000,3.99,0,87,0.51
"9379",9379,"Criminal Pursuit Force",0,2000,2000,4.99,0,70,1.49
"9380",9380,"SRPG Studio",0,2000,2000,59.99,0,20,47.99
"9381",9381,"Kinkshamed",0,2000,2000,1.99,0,25,1.49
"9382",9382,"Dega Madness",0,2000,2000,2.99,0,20,2.39
"9383",9383,"Private Detective Punch Drunk",0,2000,2000,3.99,0,30,2.79
"9384",9384,"High School: bisexual experience",0,2000,2000,0.99,0,40,0.59
"9385",9385,"Almost Alive",0,2000,2000,11.99,0,15,10.19
"9386",9386,"Whimsical Quest",0,2000,2000,2.99,0,25,2.24
"9387",9387,"Keyhole Spy: Teachers",0,2000,2000,4.99,0,50,2.49
"9388",9388,"Sakura Day 2 Mahjong",0,2000,2000,4.99,0,40,2.99
"9389",9389,"Blood Money",0,2000,2000,5.99,0,35,3.89
"9390",9390,"Frozen Knight",0,2000,2000,11.99,0,0,11.99
"9391",9391,"You Have 10 Seconds 3",0,2000,2000,2.99,0,0,2.99
"9392",9392,"拖拉机",0,2000,2000,3.99,0,40,2.39
"9393",9393,"Generation Streets",0,2000,2000,4.99,0,40,2.99
"9394",9394,"BoidWatch",0,2000,2000,0.99,0,51,0.49
"9395",9395,"Battle Princess Madelyn",0,2000,2000,19.99,0,0,19.99
"9396",9396,"HOT GIRLS VR",0,2000,2000,11.99,0,20,9.59
"9397",9397,"JumpingBoy",0,2000,2000,0.99,0,40,0.59
"9398",9398,"Rising Dusk",0,2000,2000,6.99,0,25,5.24
"9399",9399,"Lost In 80s II",0,2000,2000,1.99,0,10,1.79
"9400",9400,"Yeli Orog",0,2000,2000,2.99,0,37,1.88
"9401",9401,"Beauty and the Beast: Hidden Object Fairy Tale. HOG",0,2000,2000,2.99,0,25,2.24
"9402",9402,"ShyChess",0,2000,2000,1.99,0,30,1.39
"9403",9403,"Bunny Battle Arena",0,2000,2000,9.99,0,80,1.99
"9404",9404,"Mirror Stage",0,2000,2000,1.99,0,50,0.99
"9405",9405,"OneShift",0,2000,2000,4.99,0,50,2.49
"9406",9406,"Supaplex HARD",0,2000,2000,9.99,0,70,2.99
"9407",9407,"Welcome To... Chichester 2 : The Spy Of Chichester And The Eager Tourist Guide",0,2000,2000,0.99,0,40,0.59
"9408",9408,"DinoTrek",0,2000,2000,3.99,0,25,2.99
"9409",9409,"Anstorm",0,2000,2000,0.99,0,51,0.49
"9410",9410,"Cave under Richmordnom",0,2000,2000,0.99,0,25,0.99
"9411",9411,"Adera",0,2000,2000,11.99,0,35,7.79
"9412",9412,"Basketball Hero VR",0,2000,2000,4.99,0,50,2.49
"9413",9413,"Rapid",0,2000,2000,1.99,0,55,0.89
"9414",9414,"The Corridor: On Behalf Of The Dead",0,2000,2000,14.99,0,20,11.99
"9415",9415,"Prank Bros / 欢乐兄弟",0,2000,2000,9.99,0,40,5.99
"9416",9416,"Don't Touch Me : Zombie Survival",0,2000,2000,3.99,0,30,2.79
"9417",9417,"Forest Rabbit",0,2000,2000,1.99,0,25,1.49
"9418",9418,"Nobophobia",0,2000,2000,3.99,0,87,0.51
"9419",9419,"Survive in Angaria 2",0,2000,2000,1.99,0,65,0.69
"9420",9420,"Ice Caves of Europa",0,2000,2000,9.99,0,35,6.49
"9421",9421,"Draw It! 2",0,2000,2000,1.99,0,70,0.59
"9422",9422,"Professor Watts Memory Match: Cute Animals",0,2000,2000,0.99,0,51,0.49
"9423",9423,"Shahrzad - The Storyteller",0,2000,2000,9.99,0,30,6.99
"9424",9424,"Adventure Time: Pirates of the Enchiridion",0,2000,2000,29.99,0,50,14.99
"9425",9425,"Reveal",0,2000,2000,3.99,0,40,2.39
"9426",9426,"the Escape",0,2000,2000,0.99,0,10,0.89
"9427",9427,"Galactic Force",0,2000,2000,0.99,0,0,0.99
"9428",9428,"Galaxy Squad",0,2000,2000,9.99,0,25,7.49
"9429",9429,"Galactic Bulwark Strike",0,2000,2000,2.99,0,0,2.99
"9430",9430,"GlobalMap Astro",0,2000,2000,54.99,0,0,54.99
"9431",9431,"Gems Kingdom",0,2000,2000,2.99,0,0,2.99
"9432",9432,"I'm an adventurer",0,2000,2000,2.99,0,0,2.99
"9433",9433,"Sakura Sakura",0,2000,2000,34.99,0,0,34.99
"9434",9434,"Final Missions",0,2000,2000,3.99,0,0,0.99
"9435",9435,"Gauge Of Rage",0,2000,2000,3.99,0,0,3.99
"9436",9436,"Draw Light",0,2000,2000,1.99,0,10,1.79
"9437",9437,"Rise High",0,2000,2000,2.99,0,50,1.49
"9438",9438,"Professor Watts Word Search: Pirates Life",0,2000,2000,1.99,0,75,0.49
"9439",9439,"MechCorp",0,2000,2000,8.99,0,15,7.64
"9440",9440,"Apartment 3301",0,2000,2000,2.99,0,0,2.99
"9441",9441,"Romancing Monarchy",0,2000,2000,2.99,0,40,1.79
"9442",9442,"Nelson and the Magic Cauldron",0,2000,2000,14.99,0,10,13.49
"9443",9443,"TEEN DATE SIMULATOR",0,2000,2000,9.99,0,70,2.99
"9444",9444,"Degeneration",0,2000,2000,4.99,0,70,1.49
"9445",9445,"John Black: Memories",0,2000,2000,0.99,0,0,0.99
"9446",9446,"Mechanism",0,2000,2000,14.99,0,30,10.49
"9447",9447,"Path to Mnemosyne",0,2000,2000,9.99,0,25,7.49
"9448",9448,"Sudoku Jigsaw / 拼图数独",0,2000,2000,1.99,0,60,0.79
"9449",9449,"Space Duty",0,2000,2000,4.99,0,15,4.24
"9450",9450,"Numberline 3",0,2000,2000,1.99,0,75,0.49
"9451",9451,"Kubble",0,2000,2000,0.99,0,0,0.99
"9452",9452,"Thirty Two",0,2000,2000,0.99,0,30,0.69
"9453",9453,"В поисках Атлантиды",0,2000,2000,1.99,0,0,1.99
"9454",9454,"Volcanic Blocks",0,2000,2000,1.99,0,75,0.49
"9455",9455,"Apparition",0,2000,2000,9.99,0,20,7.99
"9456",9456,"XIII - Lost Identity",0,2000,2000,1.99,0,20,1.59
"9457",9457,"The Three Musketeers - D'Artagnan & the 12 Jewels",0,2000,2000,1.99,0,20,1.59
"9458",9458,"Grooming Adventure",0,2000,2000,1.99,0,0,1.99
"9459",9459,"Red Rover",0,2000,2000,4.99,0,40,2.99
"9460",9460,"MOAI V: Collector’s Edition",0,2000,2000,7.99,0,50,3.99
"9461",9461,"Chess Puzzles",0,2000,2000,1.99,0,75,0.49
"9462",9462,"Space Captain McCallery - Episode 1: Crash Landing",0,2000,2000,4.99,0,40,2.99
"9463",9463,"Trumpy Wall",0,2000,2000,4.99,0,81,0.94
"9464",9464,"Horror Girl Puzzle",0,2000,2000,1.99,0,40,1.19
"9465",9465,"mr.Vegan",0,2000,2000,0.99,0,40,0.59
"9466",9466,"Me And Dungeons",0,2000,2000,1.99,0,70,0.59
"9467",9467,"ELDR LEGACY",0,2000,2000,2.99,0,35,1.94
"9468",9468,"Color by Numbers - Animals",0,2000,2000,4.99,0,40,2.99
"9469",9469,"Starless Night",0,2000,2000,3.99,0,20,3.99
"9470",9470,"NEKOKORO",0,2000,2000,4.99,0,30,3.49
"9471",9471,"Anime Solitaire",0,2000,2000,4.99,0,40,2.99
"9472",9472,"The Rabbit and The Owl",0,2000,2000,9.99,0,33,6.99
"9473",9473,"Grizzly Adventure",0,2000,2000,0.99,0,51,0.49
"9474",9474,"Generic Jumper",0,2000,2000,6.99,0,25,5.24
"9475",9475,"Professor Watts Word Search: Yummy Foods",0,2000,2000,1.99,0,75,0.49
"9476",9476,"Fruit Hoop",0,2000,2000,0.99,0,30,0.69
"9477",9477,"Sword of the Guardian",0,2000,2000,12.99,0,15,11.04
"9478",9478,"NeonCode",0,2000,2000,2.99,0,40,1.79
"9479",9479,"Bunny - The Horror Game",0,2000,2000,2.99,0,70,0.89
"9480",9480,"Song Writer",0,2000,2000,6.99,0,50,3.49
"9481",9481,"NeoCandy",0,2000,2000,9.99,0,40,0.59
"9482",9482,"Sakura and Crit: The Mock Game",0,2000,2000,1.99,0,30,1.39
"9483",9483,"Professor Watts Memory Match: Fresh Fruit",0,2000,2000,0.99,0,51,0.49
"9484",9484,"Synth Ninja",0,2000,2000,1.99,0,50,0.99
"9485",9485,"The Greater Good",0,2000,2000,9.99,0,0,9.99
"9486",9486,"Swamp Jump",0,2000,2000,1.99,0,75,0.49
"9487",9487,"Hazmat Hijinks",0,2000,2000,0.99,0,80,0.49
"9488",9488,"Graveball",0,2000,2000,4.99,0,10,4.49
"9489",9489,"Forest Survival",0,2000,2000,13.99,0,0,13.99
"9490",9490,"Shining Song Starnova",0,2000,2000,29.99,0,25,22.49
"9491",9491,"End War RTS",0,2000,2000,1.99,0,50,0.99
"9492",9492,"Isle of Skye",0,2000,2000,9.99,0,60,3.99
"9493",9493,"Her 她",0,2000,2000,3.99,0,35,2.59
"9494",9494,"Save the girl",0,2000,2000,0.99,0,40,0.59
"9495",9495,"Tomato Way 2",0,2000,2000,8.99,0,70,2.69
"9496",9496,"Battleground Shooting Training 吃鸡枪法训练器",0,2000,2000,1.99,0,15,1.69
"9497",9497,"バインドを解除する(unbind)",0,2000,2000,1.99,0,0,1.99
"9498",9498,"Dungeon Kitty",0,2000,2000,3.99,0,55,1.79
"9499",9499,"Arkane Rush",0,2000,2000,2.99,0,83,0.5
"9500",9500,"Deity Empires",0,2000,2000,34.99,0,0,34.99
"9501",9501,"Gravity Leo",0,2000,2000,3.99,0,87,0.51
"9502",9502,"Simple Racing",0,2000,2000,4.99,0,40,2.99
"9503",9503,"Usual John",0,2000,2000,1.99,0,75,0.49
"9504",9504,"Escape The Labyrinth",0,2000,2000,9.99,0,25,7.49
"9505",9505,"Hentball",0,2000,2000,0.99,0,51,0.49
"9506",9506,"Amber's Airline - High Hopes",0,2000,2000,12.99,0,40,7.79
"9507",9507,"Tango: The Adventure Game",0,2000,2000,8.99,0,23,6.92
"9508",9508,"The redemption of pancakes",0,2000,2000,0.99,0,40,0.59
"9509",9509,"Kuchisake Onna - 口裂け女",0,2000,2000,2.99,0,20,2.39
"9510",9510,"BrutalAliens",0,2000,2000,0.99,0,10,0.89
"9511",9511,"Mosaics Galore. Challenging journey",0,2000,2000,4.99,0,40,2.99
"9512",9512,"CLICKER ACHIEVEMENTS - THE IMPOSSIBLE CHALLENGE",0,2000,2000,0.99,0,40,0.59
"9513",9513,"Maze Quest 1: The Forest",0,2000,2000,0.99,0,20,0.79
"9514",9514,"The 50 States Quiz",0,2000,2000,0.99,0,51,0.49
"9515",9515,"Longest Monday: Unveiling",0,2000,2000,4.99,0,75,1.99
"9516",9516,"Teenager vs.Tropical Mutants",0,2000,2000,0.99,0,51,0.49
"9517",9517,"Love Casino: Smoking Aces",0,2000,2000,4.99,0,35,3.24
"9518",9518,"The End: Inari's Quest",0,2000,2000,9.99,0,30,6.99
"9519",9519,"Gingerbread Story",0,2000,2000,4.99,0,65,1.74
"9520",9520,"STAR SHREDDERS",0,2000,2000,2.99,0,70,0.89
"9521",9521,"Attractorache",0,2000,2000,1.99,0,40,1.19
"9522",9522,"Little Dragons Café",0,2000,2000,59.99,0,20,47.99
"9523",9523,"Loca-Love My Cute Roommate",0,2000,2000,19.99,0,10,17.99
"9524",9524,"Leisure Town",0,2000,2000,0.99,0,40,0.59
"9525",9525,"Harpoon Cat",0,2000,2000,2.99,0,20,2.39
"9526",9526,"Lauren's visit",0,2000,2000,1.99,0,30,1.39
"9527",9527,"Hungry Shadows",0,2000,2000,0.99,0,51,0.49
"9528",9528,"Forsaken Remastered",0,2000,2000,19.99,0,25,14.99
"9529",9529,"The Searcher Wild West Adventure",0,2000,2000,0.99,0,51,0.49
"9530",9530,"Falldown 79: Bottle of truth",0,2000,2000,0.99,0,51,0.49
"9531",9531,"Swipe Fruit Smash",0,2000,2000,4.99,0,90,0.49
"9532",9532,"Finding Light",0,2000,2000,9.99,0,50,4.99
"9533",9533,"Snowball Saves Summer",0,2000,2000,9.99,0,30,6.99
"9534",9534,"The Lost Goblin Tower",0,2000,2000,1.99,0,15,1.69
"9535",9535,"Spaceguy: Red Space",0,2000,2000,6.99,0,0,6.99
"9536",9536,"Dawn of China: Rise of Qin",0,2000,2000,6.99,0,50,3.49
"9537",9537,"PRATAGON",0,2000,2000,4.99,0,40,2.99
"9538",9538,"TOK",0,2000,2000,0.99,0,30,0.69
"9539",9539,"DeepWeb",0,2000,2000,6.99,0,75,1.74
"9540",9540,"The Great C",0,2000,2000,5.99,0,15,5.09
"9541",9541,"Supaplex THINK!",0,2000,2000,9.99,0,70,2.99
"9542",9542,"Golf Galore",0,2000,2000,2.99,0,60,1.99
"9543",9543,"LOOT BOX ACHIEVEMENT SIMULATOR",0,2000,2000,0.99,0,33,0.66
"9544",9544,"On The Western Front",0,2000,2000,9.99,0,10,8.99
"9545",9545,"Boobs Puzzle ~| 胸部拼图",0,2000,2000,0.99,0,0,0.99
"9546",9546,"Jack N' Jill DX",0,2000,2000,4.99,0,20,3.99
"9547",9547,"Fitzzle Majestic Eagles",0,2000,2000,2.99,0,80,0.59
"9548",9548,"Beyond the Sky",0,2000,2000,12.99,0,10,11.69
"9549",9549,"Bomb Riders",0,2000,2000,1.99,0,50,0.99
"9550",9550,"Hokan: Monster Slayer",0,2000,2000,0.99,0,15,0.99
"9551",9551,"Endless Fables 3: Dark Moor",0,2000,2000,14.99,0,30,10.49
"9552",9552,"Running Naked Simulator 2019",0,2000,2000,0.99,0,15,0.84
"9553",9553,"Sophisticated Puzzle",0,2000,2000,0.99,0,51,0.49
"9554",9554,"Blood City",0,2000,2000,2.99,0,30,2.09
"9555",9555,"Sandy Path",0,2000,2000,0.99,0,51,0.49
"9556",9556,"Second Second",0,2000,2000,15.99,0,10,14.39
"9557",9557,"Oil Baron",0,2000,2000,1.99,0,60,0.79
"9558",9558,"Dead Forest",0,2000,2000,0.99,0,33,0.66
"9559",9559,"Ganbare! Super Strikers",0,2000,2000,9.99,0,25,7.49
"9560",9560,"No Crossing",0,2000,2000,1.99,0,0,1.99
"9561",9561,"UniteStar",0,2000,2000,0.99,0,15,0.84
"9562",9562,"Found Horror Game 11.exe",0,2000,2000,3.99,0,10,3.59
"9563",9563,"Devochka Quest",0,2000,2000,2.99,0,33,2
"9564",9564,"Death Race VR",0,2000,2000,14.99,0,50,7.49
"9565",9565,"Miner Ultra Wild Tides",0,2000,2000,1.99,0,50,0.99
"9566",9566,"Tales of Mahabharata",0,2000,2000,4.99,0,0,4.99
"9567",9567,"Among the Dead",0,2000,2000,4.99,0,33,3.34
"9568",9568,"VOICEACTRESSⅡ",0,2000,2000,1.99,0,40,1.19
"9569",9569,"Pranky Cat",0,2000,2000,1.99,0,10,1.79
"9570",9570,"Medical verdict",0,2000,2000,6.99,0,20,3.99
"9571",9571,"The Darkest Woods 2",0,2000,2000,2.99,0,0,2.99
"9572",9572,"Judged: A Court Simulator",0,2000,2000,6.99,0,40,4.19
"9573",9573,"2nd Circle - Powerful Magic",0,2000,2000,1.99,0,25,1.49
"9574",9574,"Maytroid. I swear it's a nice game too",0,2000,2000,1.99,0,30,1.39
"9575",9575,"Circle UP",0,2000,2000,3.99,0,0,2.99
"9576",9576,"Feed the Pets",0,2000,2000,0.99,0,45,0.54
"9577",9577,"Mad Carnage",0,2000,2000,3.99,0,50,1.99
"9578",9578,"The Occluder",0,2000,2000,1.99,0,20,1.59
"9579",9579,"Jellyfish the Ghost",0,2000,2000,0.99,0,51,0.49
"9580",9580,"Ocean Nomad: Survival on Raft",0,2000,2000,2.99,0,0,2.99
"9581",9581,"I, Cyborg",0,2000,2000,5.99,0,35,3.89
"9582",9582,"NSFWare",0,2000,2000,2.99,0,0,2.99
"9583",9583,"Grand Kokoro - Episode 1",0,2000,2000,4.99,0,15,4.24
"9584",9584,"The Witch's Apprentice: A Magical Mishap",0,2000,2000,9.99,0,50,4.99
"9585",9585,"Art of Murder - The Secret Files",0,2000,2000,4.99,0,55,2.24
"9586",9586,"属性与生活",0,2000,2000,0.99,0,0,0.99
"9587",9587,"Shooter Game",0,2000,2000,14.99,0,90,1.49
"9588",9588,"Dive Inside",0,2000,2000,2.99,0,0,2.99
"9589",9589,"TAPSONIC BOLD",0,2000,2000,19.99,0,0,19.99
"9590",9590,"Touch Down Football Solitaire",0,2000,2000,4.99,0,25,3.74
"9591",9591,"Forward Line",0,2000,2000,2.99,0,0,2.99
"9592",9592,"Arkanoid For Painters",0,2000,2000,0.99,0,51,0.49
"9593",9593,"Pleasure Puzzle:Workshop",0,2000,2000,1.99,0,40,1.19
"9594",9594,"Spacefarers!",0,2000,2000,4.99,0,25,3.74
"9595",9595,"Siam Twinstick",0,2000,2000,3.99,0,12,3.51
"9596",9596,"Darkness Restricted",0,2000,2000,1.99,0,75,0.49
"9597",9597,"Lucius III",0,2000,2000,19.99,0,10,17.99
"9598",9598,"Splotches",0,2000,2000,9.99,0,15,8.49
"9599",9599,"Close Combat: Last Stand Arnhem",0,2000,2000,39.99,0,40,23.99
"9600",9600,"Run Fairy",0,2000,2000,0.99,0,51,0.49
"9601",9601,"Space Gladiator",0,2000,2000,2.99,0,0,2.99
"9602",9602,"Primitive Survival",0,2000,2000,0.99,0,51,0.49
"9603",9603,"Tomb Reader: TrapLand",0,2000,2000,1.99,0,15,1.99
"9604",9604,"Stickman Maverick : Bad Boys Killer",0,2000,2000,2.99,0,30,2.09
"9605",9605,"Z: Escape",0,2000,2000,0.99,0,51,0.49
"9606",9606,"AmazeD 3D",0,2000,2000,1.99,0,40,1.19
"9607",9607,"Russpuppy Kid Games",0,2000,2000,4.99,0,71,1.44
"9608",9608,"The Royal Marines Commando",0,2000,2000,4.99,0,35,3.24
"9609",9609,"Echoes in White",0,2000,2000,7.99,0,30,5.59
"9610",9610,"Monster Minis Extreme Off-Road",0,2000,2000,7.99,0,20,6.39
"9611",9611,"Poisoner",0,2000,2000,2.99,0,0,2.99
"9612",9612,"A Business Power",0,2000,2000,4.99,0,20,3.99
"9613",9613,"LoveBug",0,2000,2000,4.99,0,50,2.49
"9614",9614,"Apollo 11 VR HD",0,2000,2000,9.99,0,0,9.99
"9615",9615,"Spitkiss",0,2000,2000,2.99,0,0,2.99
"9616",9616,"My Colony",0,2000,2000,4.99,0,0,4.99
"9617",9617,"The Royal Game of Ur",0,2000,2000,3.99,0,15,3.39
"9618",9618,"Mazes and Mages",0,2000,2000,0.99,0,20,0.99
"9619",9619,"Sacred Earth - Promise",0,2000,2000,12.99,0,10,11.69
"9620",9620,"HEARTBEAT",0,2000,2000,14.99,0,0,14.99
"9621",9621,"FUTURE GPX CYBER FORMULA SIN VIER",0,2000,2000,29.99,0,0,29.99
"9622",9622,"You Can(Not) Survive",0,2000,2000,4.99,0,40,2.99
"9623",9623,"Starcom: Nexus",0,2000,2000,16.99,0,15,14.44
